katakana	english
パーセント	percent
アメリカ	America
ページ	page
センター	center
サービス	service
システム	system
メートル	metre
テレビ	television
メール	mail
データ	data
フランス	France
ポイント	point
ホーム	home
ホテル	hotel
ブログ	blog
クリック	click
グループ	group
エネルギー	energy
タイプ	type
ドル	dollar
ドイツ	Germany (from Deutsch)
アップ	up
イメージ	image
スポーツ	sport
パソコン	personal computer
モデル	model
レベル	level
カード	card
チーム	team
バス	bus
アジア	Asia
ソフト	soft
イギリス	England
ファイル	file
キロ	kilo
ケース	case
ドア	door
サイト	site
チェック	check
ファックス	fax
ワン	one
ヨーロッパ	Europe
ゲーム	game
デザイン	design
ボール	ball
クラブ	club
メーカー	maker (manufacturer)
ファン	fan
インターネット	internet
ネット	net
ガス	gas
パン	bread
ライン	line
コース	course
タバコ	tabaco
カメラ	camera
テーマ	theme
テーブル	table
ベッド	bed
プロ	pro
トップ	top
イン	in
ボタン	button
コンピューター	computer
ザ	the
バランス	balance
ママ	mama
タイム	time
クラス	class
ネットワーク	network
メンバー	member
ビル	building
プログラム	program
メニュー	menu
ガラス	glas
セット	set
ロシア	Russia
スタート	start
ニュース	news
キー	key
マン	man
エンジン	engine
スタイル	style
ベース	base
コーヒー	coffee
ドラマ	drama
コスト	cost
イタリア	Italia
シート	sheet
オーケー	okay
リスク	risk
インド	India
キリスト	Christ
ウインドー	window
イベント	event
ビデオ	video
カラー	color
メディア	media
ビール	beer
オン	on
スーパー	super
パリ	Paris
ブランド	brand
キロメートル	kilometre
センチ	centimetre
テスト	test
レース	race
マンション	mansion
ミリメートル	millimetre
バー	bar
ホール	hall
ショップ	shop
ビジネス	business
トン	ton
シャツ	shirt
トイレ	toilet
スタッフ	staff
ストレス	stress
カップ	cup
ワイン	wine
スピード	speed
コメント	comment
プレー	play
ボランティア	volunteer
ルール	rule
シリーズ	series
オークション	auction
プラス	plus
クリーム	cream
オープン	open
デジタル	digital
バック	back
バッグ	bag
アドレス	address
パターン	pattern
ベスト	best
ボックス	box
フリー	free
メッセージ	message
プロジェクト	project
コーナー	corner
チャンス	chance
オブ	of
コントロール	control
ウイルス	virus
マーク	mark
ナンバー	number
ローマ	Rome
パワー	power
シーン	scene
アドバイス	advice
ショック	shock
アクセス	access
マイ	my
ブルー	blue
ラジオ	radio
タイトル	title
ユーザー	user
カー	car
プレゼント	present
コピー	copy
カレー	curry
ゴルフ	golf
ケア	care
レストラン	restaurant
テル	tell
トラブル	trouble
カット	cut
ライブ	live
ショー	show
キログラム	kilogramme
サッカー	soccer
クリスマス	Christmas
ソース	sauce
コミュニケーション	communication
ピンク	pink
コード	code
スペイン	Spain
スペース	space
スター	star
パーティー	party
リスト	list
ドライブ	drive
ユダヤ	Judaea (+ 人 = Jew)
ツール	tool
ポケット	pocket
タイヘイ	Taihei
マイナス	minus
テープ	tape
ノート	note
ワード	word
ケーキ	cake
タクシー	taxi
セックス	sex
モード	mode
サイド	side
メモ	memo
パパ	papa
ロンドン	London
アンド	and
グリーン	green
メーン	main
スープ	soup
ピアノ	piano
プラン	plan
ツアー	tour
トラック	truck
テキスト	text
バイク	bike
レンズ	lens
ハウス	house
ラーメン	ramen
プロセス	process
キス	kiss
コート	coat
リーグ	league
アフリカ	Africa
ニュー	new
ニーズ	needs
ミス	mistake
サラダ	salad
タイ	Thailand
オフ	off
パート	part
ミニ	mini
アパート	apartment
シーズン	season
ゼロ	zero
トマト	tomato
ローン	loan
ウェブ	web
オイル	oil
ボディー	body
サイズ	size
チーズ	cheese
ステージ	stage
ジャパン	Japan
パック	pack
ゴム	gum
カバー	cover
リーダー	leader
イスラム	Islam
ハイ	high
ヒット	hit
デー	day
バンド	band
イラク	Iraq
ルート	route
ルーム	room
アイディア	idea
タオル	towel
フル	full
パンツ	pants
ギリシャ	Greece
コンサート	concert
ジョン	John
ダンス	dance
グラス	glass
アルバム	album
サイン	sign
ベトナム	Vietnam
テロ	terrorism
ラブ	love
スキー	ski
ペン	pen
バター	butter
ホワイト	white
アルコール	alcohol
グラフ	graph
オフィス	office
ラン	run
ペット	pet
イエス	Jesus
リズム	rhythm
トレーニング	training
レコード	record
ステップ	step
ホルモン	hormone
メリット	merit
タイヤ	tire
バンク	bank
カウンター	counter
オーストラリア	Australia
ランキング	ranking
ブロック	block
ダウン	down
アート	art
スカート	skirt
フィルム	film
オリジナル	original
ミリ	milli
ワーク	work
ケーブル	cable
コミュニティー	community
ノー	no
ドライバー	driver
キャンプ	camp
シンプル	simple
オレンジ	orange
プール	pool
サポート	support
プレーヤー	player
セル	cell
タイミング	timing
パス	pass
メモリー	memory
ワールド	world
ゴール	goal
ブラック	black
ビタミン	vitamin
ファッション	fashion
シェア	share
サーバー	server
アニメ	animation
ツー	two
バイ	by
アウト	out
リサイクル	recycle
カナダ	Canada
インタビュー	interview
オプション	option
ダブル	double
チケット	ticket
アイテム	item
インストール	install
デビュー	debut
キッチン	kitchen
チャンネル	channel
ベルト	belt
コンクリート	concrete
スクール	school
ストーリー	story
ダイエット	diet
スーツ	suit
ディスク	disc
ミルク	milk
サラリーマン	salaryman
スイッチ	switch
マシン	machine
フード	food
トンネル	tunnel
イオン	Ion
ハリー	Harry
パネル	panel
レポート	report
ブーム	boom
ライフ	life
デート	date
マウス	mouse
フォルダー	folder
ハワイ	Hawaii
アイス	ice
アプローチ	approach
ロック	rock
バブル	bubble
ランド	land
カフェ	cafe
オール	all
レーザー	laser
オリンピック	Olympic
ブラジル	Brazil
エリア	area
ガイド	guide
ガソリン	gasoline
リード	lead
リアル	real
ペース	pace
ナイフ	knife
サン	sun
ジャケット	jacket
ダム	dam
ミリリットル	millilitre
ジョージ	George
マッサージ	massage
バイト	part-time job
フィールド	field
クリア	clear
ショート	short
プリント	print
オーナー	owner
ハード	hard
ジュース	juice
フロント	front
エアー	air
テニス	tennis
パーク	park
メーク	make
リング	ring
チェーン	chain
ボーイ	boy
ピーク	peak
アン	Ann
エッチ	H (ecchi)
リットル	litre
レンジ	range
アルバイト	Arbeit (part time job)
ソファー	sofa
ファミリー	family
ヘクタール	hectare
ランチ	lunch
ギター	guitar
キャラクター	character
グローバル	global
コンビニ	convenience
ドレス	dress
フィリピン	Philippines
パーツ	parts
ライト	light
ロード	road
アンケート	questionnaire (enquete)
ブレーキ	brake
ボトル	bottle
マスター	master
ピース	piece
スタンド	stand
キャラ	character
ボリューム	volume
イスラエル	Israel
ロボット	robot
レッド	red
マネージャー	manager
フレーム	frame
キャリア	career
バージョン	version
イラスト	illustration
ソフトウェア	software
ベンチ	bench
オーバー	over
マーケット	market
リボン	ribbon
シャワー	shower
ヒント	hint
ポスト	post
カーテン	curtain
シティー	city
ビッグ	big
レシピ	recipe
フォーム	form
マップ	map
セミナー	seminar
プラスチック	plastics
ビニール	vinyl
マネージメント	management
ワシントン	Washington
エレベーター	elevator
ダウンロード	download
アクション	action
ヘッド	head
サークル	circle
リンク	link
スポット	spot
アレルギー	allergy
トルコ	Turkey
セキュリティー	security
スケジュール	schedule
スムーズ	smooth
ゲスト	guest
ハム	ham
コレクション	collection
エジプト	Egypt
ベビー	baby
インドネシア	Indonesia
エピソード	episode
ボート	boat
プラザ	plaza
マット	mat
オペラ	opera
ショット	shot
ハート	heart
ロング	long
ズボン	trousers (zubon)
カテゴリー	category
ミサイル	missile
モニター	monitor
レッスン	lesson
マニュアル	manual
ボード	board
ユー	you
カロリー	calorie
コーチ	coach
サイクル	cycle
イラン	Iran
タンク	tank
マルクス	Marx
パートナー	partner
ファースト	first
レート	rate
キャベツ	cabbage
フロー	flow
レモン	lemon
ブック	book
フォト	photo
キャッシュ	cash
パイプ	pipe
チョコレート	chocolate
キロカロリー	kilocalorie
マリア	Maria
チップ	chip
ペーパー	paper
ログ	log
チャレンジ	challenge
ヘア	hair
アプリケーション	application
マナー	manner
センス	sense
クリニック	clinic
アラブ	Arab
スタジオ	studio
ブッシュ	Bush
タッチ	touch
マイク	microphone
インチ	inch
スイス	Switzerland
カップル	couple
ポスター	poster
ロビー	lobby
ハンドル	handle
マルチ	multi
ラッキー	lucky
サロン	salon
ドーム	dome
ジャズ	jazz
マイクロ	micro
エクセル	Excel
メカニズム	mechanism
ベル	bell
アピール	appeal
ゲット	get
アイ	eye
キャンペーン	campaign
ストック	stock
シルバー	silver
アーチスト	artist
ランプ	lamp
デパート	department
ゴールド	gold
シングル	single
クレジット	credit
シフト	shift
リア	rear
グッズ	goods
リラックス	relax
リビング	living
リース	lease
カルシウム	calcium
グランド	grand
パフォーマンス	performance
ホット	hot
マッチ	match
テクニック	technic
インフレ	inflation
エコ	eco
チョコ	chocolate
ショッピング	shopping
プレート	plate
オート	auto
データーベース	database
ロープ	rope
コラム	column
リンパ	lymph
ストレート	straight
メジャー	major
ゴー	go
ラベル	label
タグ	tag
ミスター	mister
セブン	seven
ティー	tea
タレント	talent
キャンセル	cancel
ポール	Paul
メキシコ	Mexico
マクロ	macro
アット	at
ウエート	weight
ゾーン	zone
ストップ	stop
マスク	mask
レンタル	rental
ディズニー	Disney
ナイト	night
フルーツ	fruit
グレー	gray
レディー	lady
ダイアローグ	dialogue
カーブ	curve
ニット	knit
スペシャル	special
トム	Tom
バナナ	banana
アレンジ	arrange
テント	tent
ライバル	rival
コップ	cup
タウン	town
ブラシ	brush
ウィーン	Vienna
オブジェクト	object
バッテリー	battery
ターン	turn
パッケージ	package
アンテナ	antenna
フィルター	filter
レイアウト	layout
ボス	boss
フォント	font
ランク	rank
ギャラリー	gallery
オーダー	order
ラウンド	round
ライター	writer
シャッター	shutter
バン	van
ジェット	jet
ライオン	lion
セント	saint
ポーズ	pause
ヒトラー	Hitler
プリンター	printer
インパクト	impact
ドクター	doctor
デスク	desk
ダイヤモンド	diamond
ジーンズ	jeans
クラシック	classic
デザイナー	designer
アイコン	icon
マイケル	Michael
オア	or
フォーク	fork
グラウンド	ground
デザート	dessert
クレーム	claim
スケール	scale
デッキ	deck
リー	Lee
オーブン	oven
モーター	motor
ベルリン	Berlin
ネックレス	necklace
スクリーン	screen
カウンセリング	counseling
ポジション	position
ラスト	last
オリーブ	olive
グッド	good
ジャンプ	jump
プライド	pride
エアコン	air conditioner
マイル	mile
ジャンル	genre
タブ	tab
ゲート	gate
オーストリア	Austria
ブーツ	boots
ルイ	Louis
リゾート	resort
スリー	three
ステーション	station
サンプル	sample
ビジョン	vision
ポンプ	pomp
プライバシー	privacy
エラー	error
スイング	swing
デモ	demo
ビット	bit
ウエー	way
カトリック	katholiek
スウェーデン	Sweden
ジュニア	junior
クール	cool
シンガポール	Singapore
パンフレット	pamphlet
キング	king
モンゴル	Mongol
ヘリコプター	helicopter
エリート	elite
サウンド	sound
キット	kit
ディスプレー	display
カボチャ	Cambodia
キャッチ	catch
チューブ	tube
クライアント	client
アメリカン	American
トーク	talk
レジ	register
エリザベス	Elizabeth
スイート	sweet
モスクワ	Moskva
シンボル	symbol
ベランダ	veranda
ウイスキー	whisky
カメラマン	cameraman
ビーチ	beach
タワー	tower
ポルトガル	Portugal
ベンチャー	venture
ウィン	windows
シナリオ	scenario
ファンド	fund
ガイドライン	guideline
ブラウザ	browser
マス	mass
カテ	category
ジャーナリスト	journalist
プチ	petit
カタログ	catalog
モチーフ	motif
ウォーキング	walking
スパイ	spy
ピーター	Peter
ダイヤル	dial
フライ	fly
ハッピー	happy
フロア	floor
アイドル	idol
ハーブ	herb
カリフォルニア	California
ストリート	street
スライド	slide
ドラゴン	dragon
リストラ	restructuring
ジャン	Jean
センサー	sensor
サブ	sub
ネーム	name
インフルエンザ	influenza
テンポ	tempo
マジック	magic
ウラン	Uran
マラソン	marathon
コンビ	combination
ピン	pin
プライベート	private
ポート	port
ボーナス	bonus
スプーン	spoon
チャンピオン	champion
ブラウン	Brown
パスタ	pasta
コンパクト	compact
キーボード	keyboard
メダル	medal
ベテラン	veteran
パスポート	passport
ゼリー	jelly
ソロ	solo
フォー	for
コンセプト	concept
ビュー	view
ターゲット	target
ラ	la
ソ	Soviet
ユニーク	unique
クロース	cloth
ロケット	rocket
シール	seal
コール	call
ユーロ	Euro
マネー	money
ストア	store
スピーカー	speaker
ソビエト	Soviet
パイロット	pilot
ストレッチ	stretch
ユニット	unit
メロディー	melody
ロール	roll
キャサリン	Catherine
チキン	chicken
インターナショナル	international
カジュアル	casual
マーケティング	marketing
ジム	gym
サミット	summit
ダメージ	damage
アミノ	amino
パイ	pie
レクリエーション	recreation
オーディオ	audio
ライダー	rider
プレミアム	premium
ロゴ	logotype
ローズ	Rhodes
ゴールデン	golden
ハンカチ	handkerchief
デビッド	David
ネクタイ	necktie
ミュージック	music
モダン	modern
マザー	mother
ローカル	local
ラップ	wrap
エイト	eight
ガン	gun
ハンド	hand
シャンプー	shampoo
アイヌ	Ainu
ヘルパー	helper
スロー	slow
リチャード	Richard
ラテン	Latin
アラビア	Arabia
ウォーター	water
コーラ	cola
クッキー	cookie
ミネラル	mineral
ギャップ	gap
ホスト	host
ヘッジ	hedge
エース	ace
スプレー	spray
アイルランド	Ireland
ワイド	wide
ドライ	dry
ポーランド	Poland
マフラー	muffler
イデオロギー	Ideologie
ホイール	wheel
バリア	barrier
ワイヤ	wire
インテリア	interior
カレンダー	calendar
レーダー	radar
ターミナル	terminal
アクセント	accent
ウエスト	west
ナショナル	national
スタンダード	standard
リフォーム	reform
ガール	girl
インク	ink
バックアップ	backup
シュート	shoot
ペア	pair
ガーデン	garden
タイガー	tiger
ロマン	roman
スミス	Smith
ドリンク	drink
ハーフ	half
ヒール	heel
プレス	press
プロバイダー	provider
ワゴン	wagon
アクセサリー	accessory
フィリップ	Philippe
アナログ	analog
ガード	guard
スカイ	sky
ツリー	tree
モーツァルト	Mozart
リーダーシップ	leadership
ポット	pot
アイデンティティー	identity
サンダル	sandal
トータル	total
ムード	mood
パニック	panic
レイヤー	layer
セカンド	second（第２）
リリース	release
オーケストラ	orchestra
セクション	section
ベルギー	Belgie
ヨーグルト	yogurt
コマンド	command
ワクチン	Vakzin
スタジアム	stadium
テンション	tension
ドラム	drum
パレスチナ	Palestina
パール	pearl
ボウル	bowl
ミックス	mix
デスクトップ	desktop
ミー	me
クリーン	clean
パンチ	punch
ヒーロー	hero
ロバート	Robert
キャップ	cap（帽子）
スキル	skill
チェンジ	change
アルミ	aluminium
ルーター	router
エッセー	essay
コア	core
アップル	apple
メガバイト	megabyte
セール	sale
フェース	face
ライス	rice
ピラミッド	pyramid
プディング	pudding
アルゼンチン	Argentina
レコーダー	recorder
フランク	Frank
スクリプト	script
メーター	meter
エンド	end
グルメ	gourmet
レーン	rain
ディーラー	dealer
シミュレーション	simulation
バイオリン	violin
コム	com
コンテンツ	contents
ジャム	jam
フォロー	follow
キャスト	cast
バット	bat(棒)
ピーマン	piment
ロイヤル	royal
コーディネート	coordinate
ポテト	potato
クーラー	cooler
ドゥー	do
ビーム	beam
ピザ	pizza
フォーラム	forum
キムチ	chimchi
トーマス	Thomas
パウダー	powder
プロデューサー	producer
カンボジア	Cambodia
ストーン	stone
ア	a
クロス	cross
シベリア	Siberia
ダイヤ	diagram
ポップ	pop
ソング	song
トレンド	trend
フラワー	flower
プロフィール	profile
ナポレオン	Napoleon
コレステロール	cholesterol
インシュリン	insulin
パキスタン	Pakistan
コンタクト	contact
ナトリウム	natrium
クイズ	quiz
フレンド	friend
ベージュ	beige
フラッシュ	flash
インフラ	infrastructure
バイオ	bio
シャープ	sharp
セーター	sweater
ピッチ	pitch
アダム	Adam
シルク	silk
チャールズ	Charles
ソーシャル	social
ダイニング	dining
イングランド	England
チリ	Chile
クリップ	clip
セクシー	sexy
コイン	coin
ノーマル	normal
テクノロジー	technology
ドラッグ	drug
プレッシャー	pressure
マレーシア	Malaysia
クッション	cushion
デニム	denim
メンテナンス	maintenance
ワープロ	word processor
トレード	trade
クイーン	queen
ニック	Nick
プレ	pre
メード	made
レギュラー	regular
エンジェル	angel
シンポジウム	symposium
ロー	law
ボルト	volt
テラス	terrace
バトン	baton
ベーコン	bacon
メアリー	Mary
サンドイッチ	sandwich
バトル	battle
クリーニング	cleaning
リハビリ	rehabilitation
インディアン	Indian
スコア	score
シューズ	shoes
ビザ	visa
フェスティバル	festival
スパゲッティ	spaghetti
グラフィック	graphic
ハロー	hello
イズ	is
サム	Sam
ジャバ	Java
マヨネーズ	mayonnaise
ロッテ	Lotte
キック	kick
ココ	coco
ノック	knock
ホームズ	Holmes
パトロール	patrol
バラエティー	variety
コミック	comic
デフレ	deflation
ズーム	zoom
アナウンサー	announcer
ギガバイト	gigabyte
ミステリー	mystery
リクエスト	request
フォーマット	format
ミッション	mission
テン	ten
バケツ	bucket
ボストン	Boston
アカデミー	academy
ペルシャ	Persia
ウィリアム	William
ティッシュ	tissue
ニュアンス	nuance
ナチス	Nazis
ビーズ	beads
ラリー	rally
ニュージーランド	New Zealand
パレット	pallet
プラント	plant
アフガニスタン	Afghanistan
アマチュア	amateur
スターリン	Stalin
ポンド	pond
シカゴ	Chicago
カール	Karl
ビー	be
ブリッジ	bridge
ライセンス	license
コンサルタント	consultant
タイル	tile
バレー	volley
モビール	mobile
アニメーション	animation
アテネ	Athens
エプロン	apron
チャット	chat
ブラウス	blouse
ブレーク	break
メソッド	method
マガジン	magazine
ゲリラ	guerrilla
サングラス	sunglasses
トランク	trunk
フェリー	ferry
ヨーガ	yoga
ナチュラル	natural
バリエーション	variation
コンクール	concours
ベクトル	vector
ペニス	penis
ライフスタイル	lifestyle
モデム	modem
レール	rail
ハリウッド	Hollywood
ケイト	Kate
カウンセラー	counselor
セラー	seller
ベイ	bay
ルネサンス	Renaissance
ディーゼル	diesel
ハンガリー	Hungary
エクスプレス	express
ラッシュ	rush
レビュー	review
チャート	chart
フォン	fond
シルエット	silhouette
ロマンチック	romantic
インターフェース	interface
ダイレクト	direct
トライ	try
コンテスト	contest
スライス	slice
ネック	neck
アール	are
スマート	smart
フォード	Ford
ベン	Benn
キャプテン	captain
ウォーク	walk
ジェームズ	James
ドレッシング	dressing
ハイテク	high technology
パー	par
ユーモア	humor
レタス	lettuce
デバイス	device
ドキュメント	document
ファイバー	fiber
ループ	loop
ノン	non
アーチ	arch
ゲイ	gay
リレー	relay
サーキット	circuit
トーン	tone
エントリー	entry
パケット	packet
カルチャー	culture
カンパニー	company
ダート	dart
ヘルプ	help
スケッチ	sketch
マニア	mania
ロサンゼルス	Los Angeles
ワーカー	worker
ディレクター	director
デメリット	demerit
ドメイン	domain
クローズ	close
シェフ	chef
ノイズ	noise
ヒップ	hip
ステーキ	steak
ストーブ	stove
パトカー	patrol car
ウルトラ	ultra
レジャー	leisure
アンサー	answer
ポッド	pod
ストラップ	strap
ウォッチ	watch
キープ	keep
アカウント	account
ディナー	dinner
ドッグ	dog
フェラーリ	Ferrari
マックス	max
スポンジ	sponge
ファー	fur
ビートル	Beatles
メロン	melon
ミシン	sewing machine
レス	less
スポンサー	sponsor
ミラノ	Milano
ドック	dock
ミッキー	Mickey
レバー	liver
サポーター	supporter
カレッジ	college
セクター	sector
セルフ	self
グリップ	grip
ウエーブ	wave
テロリスト	terrorist
ロケ	location
ミーティング	meeting
コンテナ	container
バンコク	Bangkok
ルイス	Lewis
アクセル	accelerater
ドリーム	dream
ナビ	navigation
ウイーク	week
ミュージシャン	musician
ハンバーグ	hamburg
ヨット	yacht
スペック	spec
ムハンマド	Muhammad
アナ	announcer
ジャングル	jungle
ピストル	pistol
フレンチ	French
プラグ	plug
ランナー	runner
パレード	parade
ベートーベン	Beethoven
モラル	moral
モール	mall
アルミニウム	aluminium
スティック	stick
ソナタ	sonata
テースト	taste
キューバ	Cuba
スト	strike
ロス	loss
オートバイ	auto bicycle
セールス	sales
チャン	channel
アンチ	anti
イエロー	yellow
インフォメーション	information
カクテル	cocktail
コーン	corn
トリック	trick
スルー	through
アー	are
ドロップ	drop
アルカリ	alkali
ベール	veil
ホーク	hawk
リハビリテーション	rehabilitation
ジャーナリズム	journalism
オーラ	aura
カート	cart
スナック	snack
ソーセージ	sausage
リターン	return
アンダー	under
コイル	coil
ダーク	dark
パジャマ	pajamas
アインシュタイン	Einstein
マリン	marine
コンプレックス	complex
ドット	dot
パーソナル	personal
フラット	flat
ヘッダー	header
スロット	slot
バレエ	ballet
スコットランド	Scotland
サイエンス	science
ヒル	hill
フェア	fair(見本市)
ペリー	Perry
ホモ	homo
ミクロ	micro
ビルマ	Burma
キリシタン	Christian
カウント	count
ジェーン	Janes
エステ	aesthetic
プロレス	professional wrestling
ミラー	mirror
アトリエ	atelier
ソックス	socks
バレンタイン	Valentine
リトル	little
ベンツ	Benz
キャラメル	caramel
ミュージカル	musical
グローブ	glove
コロンビア	Columbia
オールド	old
ヒロイン	heroine
ボーカル	vocal
レア	rare
オゾン	ozone
アダルト	adult
ギヤ	gear
タスク	task
アウトルック	outlook
アリバイ	alibi
サマー	summer
カセット	cassette
サンデー	Sunday
スタンス	stance
ホース	hoos
ヤード	yard
ガム	gum
シニア	senior
デンマーク	Denmark
パッド	pad
エキス	extract
カーボン	carbon
ナショナリズム	nationalism
レザー	leather
シチュー	stew
キッド	kid
スチール	steel
ダイオキシン	dioxin
ヘルメット	helmet
アクティブ	active
スピーチ	speech
トーナメント	tournament
パブリック	public
リフレッシュ	refresh
マッカーサー	MacArthur
マクドナルド	MacDonald
ピンチ	pinch
プロトコル	protocol
ベーシック	basic
キュート	cute
スクエア	square
ペダル	pedal
レントゲン	roentgen
ノートン	Norton
スキャン	scan
ノーベル	Nobel
メイ	May
メタル	metal
ダイナミック	dynamic
フィンランド	Finland
ベネチア	Venezia
メガヘルツ	megahertz
クリントン	Clinton
スタンプ	stamp
バスケット	basket
ヤン	Jan
レター	letter
ハン	Khan
レフ	reflex
アセスメント	assessment
コスモス	cosmos
ムービー	movie
エンターテインメント	entertainment
バルブ	bulb
パラメーター	parameter
ブロードバンド	broadband
スケート	skate
パンプス	pumps
リサーチ	research
グレード	grade
シドニー	Sydney
スローガン	slogan
ニューロン	neuron
パルス	pulse
モニタリング	monitoring
ラグビー	rugby
リッチ	rich
ギャンブル	gamble
ツイン	twin
フィット	fit
スニーカー	sneaker
スパ	spa
オープニング	opening
カリキュラム	curriculum
ピッチャー	pitcher
コマーシャル	commercial
ペルー	Peru
マーチン	Martin
シー	sea
ディープ	deep
パンク	punk
ファイア	fire
キャット	cat
モーガン	Morgan
エトセトラ	et cetra
ピー	pea
エクスプローラー	explorer
ナース	nurse
アマゾン	Amazon
サーカス	circus
リアリティー	reality
シャンパン	champagne
フィードバック	feedback
ポートフォリオ	portfolio
キャンバス	canvas
パンダ	panda
ユニホーム	uniform
ランニング	running
ジェル	gel
ステンレス	stainless
ペイント	paint
カントリー	country
ビジネスマン	businessman
プレビュー	preview
ポジティブ	positive
イヤー	year
アーサー	Arthur
スキャンダル	scandal
スプリング	spring
ネール	nail
ニーチェ	Nietzsche
シンク	think
ヘルス	health
ジェンダー	gender
ネガティブ	negative
ファンタジー	fantasy
モンスター	monster
ヒーター	heater
フレーズ	phrase
サプリメント	supplement
ロッカー	locker
イブ	Eve
ウッド	wood
スコット	Scott
パセリ	parsley
フィギュア	figure
ポーチ	porch
リフト	lift
ホームレス	homeless
マスカラ	mascara
ノルウェー	Norway
フライト	flight
セッティング	setting
ピエール	Pierre
プリンス	prince
ウイング	wing
クーデター	coup d'Etat
ヒンドゥー	Hindu
ブロッコリー	broccoli
ウエア	wear
スピン	spin
ハット	hat
アシスタント	assistant
エージェント	agent
タイムリー	timely
トピック	topic
カスタム	custom
ファイブ	five
ヤング	young
アラン	Alain
インスタント	instant
トレー	tray
ハンター	hunter
レンタカー	rent-a-car
カーペット	carpet
ゴロ	grounder
マイナー	minor
アイロン	iron
ガレージ	garage
エージ	age
ステロイド	steroid
ヤンキー	Yankee
ライブラリー	library
キャンパス	campus
タイマー	timer
アルファベット	alphabet
ステー	stay
ノブ	knob
モン	Mont
スカーフ	scarf
トースト	toast
ヘンリー	Henry
メンタル	mental
キャピタル	capital
コーディネーター	coordinator
ケネディ	Kennedy
トランス	trans
ドリル	drill
バニラ	vanilla
テール	tail
ヘリ	helicopter
ボイス	voice
ユース	youth
ダイビング	diving
ルーマニア	Rumania
ワックス	wax
エコー	echo
コーラス	chorus
チューン	tune
バレーボール	volleyball
フラン	franc
エドワード	Edward
ベリー	berry
カーソル	cursor
ピックアップ	pick-up
フロイト	Freud
ウィズ	with
セレクト	select
フロム	from
ミシェール	Michelle
スパイス	spice
ビジュアル	visual
モジュール	module
アース	earth
コットン	cotton
ホステス	hostess
リップ	lip
アトピー	atopy
イレブン	eleven
カント	Kant
ブルジョア	bourgeois
ボン	Bonn
メガ	mega
マドリード	Madrid
マント	manteau
シックス	six
セッション	session
バグダッド	Bagdad
カラフル	colorful
コン	concert
ハイキング	hiking
ミセス	Mrs
モーニング	morning
コロッケ	croquette
サルトル	Sartre
ビクトリア	Victoria
ブース	booth
レ	les
アスファルト	asphalt
クオリティー	quality
シャフト	shaft
ペースト	paste
ワークショップ	workshop
カッター	cutter
シアター	theater
テレビジョン	television
ペンキ	pek
カプセル	Kapsel
タブー	taboo
アタック	attack
スペクトル	spectre
ランダム	random
リ	ris
ウォー	war
マーカー	marker
ラウンジ	lounge
アンティーク	antique
ダッシュ	dash
テレホン	telephone
ハードウェア	hardware
フロッピー	floppy
フィレンツェ	Firenze
ポインター	pointer
イタリアン	Italian
ココア	cocoa
シェークスピア	Shakespeare
ルーツ	roots
ウィザード	wizard
パーマ	permanent wave
リューマチ	rheumatism
アダプター	adapter
ゲノム	Genom
シック	chic
ボクシング	boxing
クリスタル	crystal
マダム	madam
ミュージアム	museum
ルーク	rook
アンプ	amplifier
クラッチ	clutch
ケリー	Kelly
ジョーンズ	Jones
ハンセン	Hansen
マリ	Mali
ジュネーブ	Geneve
ターボ	turbo
ハーバード	Harvard
マギー	Maggi
ルソー	Rousseau
レコーディング	recording
コントラスト	contrast
ファイナル	final
ブル	bull
プロダクション	production
リン	Lynn
フセイン	Hussein
プレゼンテーション	presentation
アーム	arm
ウエディング	wedding
パズル	puzzle
レーガン	Reagan
シグナル	signal
チョイス	choice
ディレクトリー	directory
トルク	torque
ポピュラー	popular
メッセンジャー	messenger
ウルグアイ	Uruguay
コンディション	condition
シリコン	silicon
フットボール	football
フレッシュ	fresh
ハンデ	handicap
フック	hook
ユニバーサル	universal
アナウンス	announce
アフター	after
カルテ	Karte
ショパン	Chopin
エンジニア	engineer
ブレンド	blend
ステッチ	stitch
ボンド	bond
イノベーション	innovation
ニュートン	Newton
チューリップ	tulip
プログラミング	programming
ポリス	police
マラリア	malaria
ピル	pill
プロテスタント	Protestant
レーニン	Lenin
シェル	shell
ピアニスト	pianist
フェンス	fence
ワット	watt
スキン	skin
スタイリスト	stylist
ツーリング	touring
クリスチャン	Christian
コンセント	consent
シロップ	siroop
ノット	not
ハイウエー	highway
ハンバーガー	hamburger
ナイン	nine
パウロ	Paulos
ポロ	polo
ダニエル	Daniel
ウィリアムズ	Williams
オルガン	orgao
トレーナー	trainer
キャンデー	candy
チェコ	Czech
プロデュース	produce
ガーゼ	Gaze
サンド	sandwich
シャドー	shadow
スカウト	scout
バスルーム	bathroom
プラットホーム	platform
メッシュ	mesh
ユナイテッド	united
ルチア	Lucia
アルプス	Alps
インセンティブ	incentive
コンドーム	condom
ダウ	Dow
シナプス	synapse
ジョンソン	Johnson
チューナー	tuner
インデックス	index
カリスマ	charisma
ストローク	stroke
セメント	cement
パット	putt
フォーン	phone
ワイルド	wild
チェリー	cherry
ビート	beat
ラフ	rough
セリーナ	Serena
ライフル	rifle
ダンサー	dancer
プラトン	Platon
マインド	mind
ラインアップ	lineup
イニシアチブ	initiative
キャンドル	candle
クローン	clone
ドキュメンタリー	documentary
バスター	buster
ポリ	poly
マンハッタン	Manhattan
カイロ	Cairo
キャスター	caster
シャルル	Charles
ストライキ	strike
ヘルシー	healthy
オナニー	Onanie
ジャージー	jersey
ハブ	have
バッター	batter
ブラン	blanc
アリーナ	arena
エンディング	ending
オリックス	ORIX
ギャグ	gag
ハムスター	hamster
エアロ	aero
ケチャップ	ketchup
スナップ	snap
スリム	slim
ハニー	honey
プラズマ	plasma
ホルダー	holder
インナー	inner
オンリー	only
ジョギング	jogging
ソープ	soap
カリウム	kalium
サーブ	serve
ジョーク	joke
ステレオ	stereo
スーツケース	suitcase
ミドル	middle
コカ	coca
ストーカー	stalker
アウトドア	outdoor
ウォール	wall
ブルーベリー	blueberry
ボウリング	bowling
アトラクション	attraction
ステート	state
ディテール	detail
ハンマー	hammer
レポーター	reporter
スタディー	study
ヒアリング	hearing
マフィア	Mafia
ウィルソン	Wilson
シリア	Syria
バイパス	bypass
フォース	force
アルツハイマー	Alzheimer
ウイル	will
ストッキング	stocking
ミント	mint
ラグ	lag
アドバイザー	adviser
グローバリゼーション	globalization
コンサルティング	consulting
コンセンサス	consensus
セクハラ	sexual harassment
カム	come
セロリ	celery
アーモンド	almond
プルトニウム	plutonium
ジャー	jar
スリッパ	slipper
ブラザー	brother
ボーダー	border
マルク	Mark
サウナ	sauna
チャイルド	child
ビーナス	Venus
ヘーゲル	Hegel
オックスフォード	Oxford
サイレン	siren
ウィンナ	Vienna
チューニング	tuning
ポルノ	pornography
ギャル	gal
クラスメート	classmate
サード	third
ファンデーション	foundation
エッセンス	essence
エリス	Ellis
ストライプ	stripe
ノース	north
プッシュ	push
グランプリ	grand prix
ティ	ti
ナイロン	nylon
ビーフ	beef
エルサレム	Jerusalem
スリップ	slip
テキサス	Texas
ネパール	Nepal
ブレスレット	bracelet
ロン	Long
コック	cook
コーラン	Koran
ヒューマン	human
ムスリム	Muslim
ライナー	liner
ルナ	luna
アクリル	acryl
キリ	cruz
サスペンション	suspension
ジャクソン	Jackson
ドーナツ	doughnut
ネオン	neon
マイクロメートル	micrometer
ミイラ	mirra
コメディー	comedy
コンボ	combo
ピット	pit
ロット	lot
ガイドブック	guidebook
ミサ	missa
モザイク	mosaic
チーフ	chief
デス	death
バード	bird
ルーズベルト	Roosevelt
ロマンス	romance
ウール	wool
カツ	cutlet
パーカ	parka
プル	pull
ルアー	lure
ウェル	well
ハーモニー	harmony
フルート	flute
ワーキング	working
グーグル	Google
フェスタ	festa
ブランデー	brandy
マグネシウム	magnesium
レトロ	retro
アングル	angle
コメ	comment
テーク	take
ネオ	neo
ラベンダー	lavender
テレサ	Teresa
ハードル	hurdle
マルチメディア	multimedia
リバー	river
レイプ	rape
エッグ	egg
クライマックス	climax
シャトル	shuttle
ストライク	strike
ピント	brandpunt
エクササイズ	exercise
スーパーマーケット	supermarket
ヘビー	heavy
リニューアル	renewal
クーリング	cooling
サプライ	supply
シンドローム	syndrome
プロペラ	propeller
マレー	Malay
ウーマン	woman
ステータス	status
ネーミング	naming
フラ	hula
アンリ	Henri
エレガント	elegant
クイック	quick
クッキング	cooking
ゴリラ	gorilla
サウジアラビア	Saudi Arabia
ホラー	horror
ミキサー	mixer
イコール	equal
アッラー	Allah
イースト	east
ゴシック	Gothic
セーラー	sailor
ナウ	now
ラオス	Laos
ハンサム	handsome
バッジ	badge
ピーナッツ	peanuts
セグメント	segment
ビキニ	bikini
ファクター	factor
ロッキード	Lockheed
アンカー	anchor
スマイル	smile
ナチ	Nazi
クラフト	craft
クロゼット	closet
コレクター	collector
バルコニー	balcony
ヒート	heat
ボトム	bottom
リハーサル	rehearsal
ルー	roux
クルー	crew
ゲージ	gauge
ゴージャス	gorgeous
シチュエーション	situation
セクシャル	sexual
ニー	knee
ブルガリア	Bulgaria
アフガン	Afghan
イルミネーション	illumination
サック	sack
ジャーナル	journal
スタイリング	styling
トリートメント	treatment
エッジ	edge
ゴルファー	golfer
パーティション	partition
ライ	rye
ウエートレス	waitress
カヌー	canoe
ディフェンス	defense
トランプ	trump
ペナルティー	penalty
マグマ	magma
マニラ	Manila
エディター	editor
クルーズ	cruise
バスク	Basque
ピエロ	pierrot
ピボット	pivot
ラット	rat
ルーズ	loose
カルテル	Kartell
ファクシミリ	facsimile
ヨハネ	Iohannes
クラウン	crown
セーブ	save
ソクラテス	Sokrates
デリバティブ	derivative
ハワード	Howard
リセット	reset
エロ	erotic
スラム	slum
ヘッドライト	headlight
アップデート	update
ウーロン	oolong
ステアリング	steering
トラスト	trust
パラダイム	paradigm
ピクセル	pixel
ムーン	moon
ヨルダン	Jordan
ゴルバチョフ	Gorbachyov
セーフ	safe
ソーダ	soda
パノラマ	panorama
フロリダ	Florida
ポリシー	policy
マグ	mug
キム	Kim
ギガヘルツ	gigahertz
ドラフト	draft
リタイア	retire
グラニュー	granulated
サントリー	Suntory
セーフティー	safety
ソフトボール	softball
ダービー	Derby
チタン	Titan
ハイブリッド	hybrid
マスト	must
ヨゼフ	Josef
オアシス	oasis
カジノ	casino
ケージ	Cage
スパイク	spike
タルト	tarte
ノア	Noah
フィクション	fiction
ウェア	ware
コンビニエンス	convenience
ジャンパー	jumper
ロレンス	Lawrence
アンデルセン	Andersen
セントラル	central
バリュー	value
ファインダー	finder
ニクソン	Nixon
ファシズム	fascism
ペンギン	penguin
ロース	roast
シスター	sister
シンガー	singer
ファーム	farm
ミュンヘン	Munchen
オードリー	Audrey
カーディガン	cardigan
ゲイン	gain
トッピング	topping
バンパー	bumper
ピストン	piston
キース	Keith
サンプリング	sampling
シュー	chou
ジャワ	Java
チャイム	chime
チャック	Chuck
パーソン	person
プロフェッショナル	professional
プロポーズ	propose
ルック	look
アンモニア	ammonia
トレ	train
エール	yell
ナプキン	napkin
ファイナンス	finance
ムース	mousse
エスカレート	escalate
クエリー	query
レンジャー	ranger
ロフト	loft
オフィシャル	official
コスメ	cosmetic
セールスマン	salesman
ハザード	hazard
バルセロナ	Barcelona
ブロー	blow
プロダクト	product
メタ	meta
ウォッカ	vodka
プロモーション	promotion
コンデンサー	condenser
コンプライアンス	compliance
スノー	snow
デフォルト	default
バングラデシュ	Bangladesh
プレーン	plain
マル	Mal
リーチ	Leech
カルロス	Carlos
ガッツ	guts
サーモン	salmon
リュック	rucksack
ワーグナー	Wagner
アンコール	encore
インテリ	intelligentsiya
クラスター	cluster
ジープ	Jeep
バスケットボール	basketball
ペイオフ	pay-off
リベラル	liberal
シェープ	shape
ダビデ	David
バイキング	Viking
バスト	bust
バーチャル	virtual
プロイセン	Preussen
マウンテン	mountain
リモート	remote
ゲーテ	Goethe
カテーテル	katheter
ゴッホ	Gogh
ショルダー	shoulder
チャリティー	charity
トラウマ	trauma
ファイト	fight
グリル	grill
コースター	coaster
ニッケル	nickel
ローション	lotion
オリバー	Oliver
ギャング	gang
コラーゲン	collagen
シップ	ship
ボーダフォン	Vodafone
タン	tongue
プリンセス	princess
ボナパルト	Bonaparte
モチベーション	motivation
ラム	rum
エデン	Eden
クロム	chrome
ストロー	straw
デア	der
ピアー	peer
アル	al
エンター	enter
シリンダー	cylinder
ジョゼフ	Joseph
タフ	tough
メス	mes
ゴードン	Gordon
ダン	Dan
ナッツ	nuts
ハイビジョン	highvision
プロセッサー	processor
ルーフ	roof
ワルツ	waltz
イワン	Ivan
オブジェ	objet
セダン	sedan
チェア	chair
フォーカス	focus
フローリング	flooring
ブーケ	bouquet
アンサンブル	ensemble
イット	it
エタノール	Athanol
オペレーション	operation
カリ	kali
クウェート	Kuwait
セオリー	theory
デル	del
ヒマラヤ	Himalaya
メグ	Meg
ユーゴスラビア	Yugoslavia
ルパン	Lupin
レスラー	wrestler
ローラー	roller
カットソー	cut sewn
クリーナー	cleaner
ツナ	tuna
パルプ	pulp
ビスケット	biscuit
ピカソ	Picasso
ブラインド	blind
ジニー	Jinny
ハンドバッグ	handbag
バジル	basil
マーチ	march
レオナルド	Leonard
アパートメント	apartment
エバ	Eva
カフェイン	Kaffein
キューブ	cube
グレート	great
ゼネラル	general
テイラー	Taylor
ナンシー	Nancy
ポッター	Potter
ファウル	foul
ペンダント	pendant
リール	reel
クレーン	crane
シュトラウス	Strauss
ショーツ	shorts
デッド	dead
ナノ	nano
ピクニック	picnic
フッター	footer
リクルート	recruit
イラストレーター	illustrator
ウエスタン	Western
ガバナンス	governance
シンナー	thinner
ジュエリー	jewelry
スチュワーデス	stewardess
ディ	di
ディアー	dear
ノーマン	Norman
ウェブサイト	website
シネマ	cinema
ステ	station
ストロボ	strobo
ダイアナ	Diana
ダーウィン	Darwin
パンティー	pantie
キャロル	Carroll
ハリス	Harris
バナー	banner
パブ	pub
ファイター	fighter
マルコ	Marco
マンゴー	mango
モットー	motto
ルーカス	Lucas
アラスカ	Alaska
クリスティー	Christie
ケイ	Kay
ケンブリッジ	Cambridge
セットアップ	set-up
バロック	baroque
ヒストリー	history
イーグル	eagle
グラタン	gratin
コンビナート	kombinat
ジ	the
ジレンマ	dilemma
ヌード	nude
ファスナー	fastener
アポロン	Apollon
ギフト	gift
クラーク	Clark
サリー	sari
シンデレラ	Cinderella
タップ	tap
デーリー	daily
モリス	Morris
カリブ	Carib
キラー	killer
シアトル	Seattle
ジャイアント	giant
マウンド	mound
ワトソン	Watson
アイランド	island
アクア	aqua
キュー	cue
サー	Sir
スピリット	spirit
ムーア	Moore
コント	conte
スクーター	scooter
スチロール	Styrol
チェロ	cello
チンパンジー	chimpanzee
ハッチ	hatch
バイオテクノロジー	biotechnology
フィッシュ	fish
フェニックス	phoenix
フット	foot
フロンティア	frontier
ボクサー	boxer
アロマ	aroma
ココナッツ	coconut
コンソメ	consomme
ジュール	joule
スポーティー	sporty
モロッコ	Morocco
リーフ	leaf
アイアン	iron
グルコース	glucose
サリン	sarin
デモクラシー	democracy
ハンガー	hanger
バドミントン	badminton
メタン	Methan
ウクライナ	Ukraina
セラピー	therapy
バグ	bug
パーソナリティー	personality
ファイナンシャル	financial
ヘルツ	hertz
ペプチド	peptide
レスポンス	response
ロースト	roast
クロック	clock
サーフィン	surfing
フェルト	felt
マトリックス	matrix
シャベル	shovel
ノイローゼ	Neurose
ビデオテープ	videotape
ボー	beau
レオ	Leo
エスカレーター	escalator
ジーパン	jeans pants
チャイナ	China
パーキング	parking
ビーン	bean
ペイン	pain
ポテンシャル	potential
レバノン	Lebanon
ロッジ	lodge
アウェー	away
キャビン	cabin
シュガー	sugar
ジュリアン	Julianne
セシル	Cecil
タリバン	Taliban
ハーマイオニー	Hermione
バーゲン	bargain
ボンネット	bonnet
マート	mart
ミート	meet
メンテ	maintenance
ユア	your
ルックス	looks
ローター	rotor
エゴ	ego
ガンジー	Gandhi
ニコチン	nicotine
ニックネーム	nickname
バザー	bazaar
パーフェクト	perfect
インストラクター	instructor
コントローラー	controller
タイト	tight
ベースボール	baseball
メカ	mechanism
メタボリック	metabolic
クリ	clitoris
タービン	turbine
プラハ	Praha
ビトン	Vuitton
プラチナ	platina
モーション	motion
ユニオン	union
ガイ	guy
スクロール	scroll
スリル	thrill
ファクトリー	factory
ブロンド	blond
ユニクロ	UNIQLO
シンクロ	synchro
バッティング	batting
バーガー	burger
ブティック	boutique
レーサー	racer
サザン	southern
スリランカ	Sri Lanka
トッド	Todd
ロッド	rod
ロータリー	rotary
エロス	eros
シナモン	cinnamon
ショコラ	chocolat
スキャナー	scanner
セン	sen
インポート	import
エルメス	Hermes
デリケート	delicate
ニール	Neill
アレキサンダー	Alexander
オクラ	okra
シェリー	Shelley
スタミナ	stamina
パープル	purple
ブラジャー	brassiere
ミニチュア	miniature
ラケット	racket
オリエンタル	oriental
カーター	Carter
ナイル	Nile
パイナップル	pineapple
アパレル	apparel
セラピスト	therapist
ソプラノ	soprano
フェンダー	fender
スウェット	sweat
ノルマ	Norma
ビルダー	builder
フィニッシュ	finish
リズ	Liz
エステル	ester
ギブ	give
パステル	pastel
ピュア	pure
マリーナ	marina
レッテル	letter
インターホン	interphone
ウィル	Will
ウエーター	waiter
ニコライ	Nikolai
エナメル	enamel
オバマ	Obama
マニキュア	manicure
コンペ	competition
シモン	Simon
ジャスト	just
スパイウェア	spyware
チャプター	chapter
パシフィック	pacific
ベター	better
モノクロ	monochrome
レインボー	rainbow
ウインク	wink
オスマン	Osman
カーニバル	carnival
サーチ	search
シーク	Sikh
ゼラチン	gelatin
フラッグ	flag
ベルサイユ	Versailles
ポツダム	Potsdam
メッカ	Mecca
メート	mate
コリン	Colin
シード	seed
スキーム	scheme
トランペット	trumpet
ハイライト	highlight
パロディー	parody
フランクフルト	Frankfurt am Main
マーシー	Marcy
ステークス	stakes
タンゴ	tango
バイアス	bias
ビック	vic
フロン	flon
リメーク	remake
イヤリング	earring
エキストラ	extra
カスタマイズ	customize
コーティング	coating
シークエンス	sequence
ステッカー	sticker
チェックポイント	checkpoint
トースター	toaster
ナポリ	Napoli
ブレード	blade
プライス	price
スクープ	scoop
ノンフィクション	nonfiction
バーレル	barrel
パレス	palace
マイルド	mild
ライム	lime
ストール	stall
ソケット	socket
ダリア	dahlia
バッファー	buffer
プランター	planter
ガブリエル	Gabriel
クーポン	coupon
シャイ	shy
スラブ	Slav
ドラマチック	dramatic
ナンセンス	nonsense
リナックス	Linux
インプット	input
キャッチフレーズ	catchphrase
バースデー	birthday
ビンテージ	vintage
リアリズム	realism
アスリート	athlete
アレンジメント	arrangement
アンバランス	unbalance
エレクトロニクス	electronics
キロヘルツ	kilohertz
ケニア	Kenya
コーポレーション	corporation
シャーシー	chassis
ジョイント	joint
トリオ	trio
フェミニズム	feminism
フレッド	Fred
マルコム	Malcolm
ローテーション	rotation
グルジア	Gruziya
サバイバル	survival
スクリュー	screw
ソロモン	Solomon
テク	technic
トロイ	Troy
ナレーション	narration
ベンジャミン	Benjamin
オリオン	Orion
オー	aux
コネ	connection
スタメン	starting member
セレモニー	ceremony
ネーチャー	nature
パワフル	powerful
マッキントッシュ	Macintosh
マージン	margin
リビア	Libya
リブ	live
オーディション	audition
クレープ	crepe
グラビア	gravure
ダビング	dubbing
デッサン	dessin
ポータブル	portable
マウント	mount
ユートピア	Utopia
レスリング	wrestling
アシスト	assist
オーク	oak
ガリレオ	Galileo
コンベンション	convention
テンプレート	template
ハイデッガー	Heidegger
パラダイス	paradise
モルヒネ	morfine
エメラルド	emerald
キャッチャー	catcher
グレープフルーツ	grapefruit
シークレット	secret
トス	toss
トランジスタ	transistor
ドリフト	drift
パトリック	Patrick
ビューティー	beauty
フランツ	Franz
フリル	frill
マサチューセッツ	Massachusetts
アーケード	arcade
エンジニアリング	engineering
カタロニア	Catalonia
キャビネット	cabinet
ジャパニーズ	Japanese
ジャンク	junk
ファイアーウォール	firewall
マッシュルーム	mushroom
マッハ	Mach
リーズナブル	reasonable
アルゴリズム	algorithm
アンドレ	Andre
インドシナ	Indochina
インフレーション	inflation
クランク	crank
サスペンス	suspense
サンタクロース	Santa Claus
ポリマー	polymer
リオ	Rio
カラーリング	coloring
キロバイト	kilobyte
シャー	shah
シリアル	cereal
ジャネット	Janet
スカ	ska
セルビア	Serbia
ハープ	harp
ブッダ	Buddha
メタボ	metabolic
コラボ	collaboration
ダンプ	dump
ピープル	people
ラック	rack
エコロジー	ecology
オッズ	odds
オリエント	Orient
カープ	carp
コネクター	connector
コロニー	colony
ダイオード	diode
ヌーボー	nouveau
ハロウィーン	Halloween
ガーデニング	gardening
クリエーティブ	creative
テナント	tenant
トレーン	train
ネル	flannel
プレース	place
ボディーガード	bodyguard
ライカ	Leica
アウトレット	outlet
アジアン	Asian
エフェクト	effect
エレメント	element
ゴッド	god
スタイン	Stein
ダイバー	diver
ダミー	dummy
トイレット	toilet
トレーラー	trailer
ニコラス	Nicholas
フォーマル	formal
メッセ	Messe
リンカーン	Lincoln
アトム	atom
カースト	caste
シフォン	chiffon
スクラップ	scrap
ソテー	saute
ナット	nut
パイオニア	pioneer
メディカル	medical
リバウンド	rebound
エコノミー	economy
クレヨン	crayon
ゲルマン	Germane
スモーク	smoke
デュシャン	Duchamp
バッファロー	buffalo
ブロンズ	bronze
ホープ	hope
メラニン	melanin
メリー	merry
レファレンス	reference
ゲイブ	Gab(e)
サイバー	cyber
シチリア	Sicilia
ディスコ	disco
ドール	d'Or
ビンゴ	bingo
マドンナ	Madonna
メル	mel
モスク	mosque
ライティング	writing
リベンジ	revenge
カオス	chaos
サイクリング	cycling
サイパン	Saipan
ジェイ	jay
スモール	small
タックル	tackle
ディスカッション	discussion
ドナー	donor
パッチ	patch
プライマリー	primary
ポーター	porter
アイドリング	idling
アルジェリア	Algeria
イングリッシュ	English
ウォッチング	watching
ハノイ	Hanoi
ピクチャー	picture
ヘッドホン	headphone
レパートリー	repertory
コンパス	kompas
スカイライン	skyline
ゼウス	Zeus
トリミング	trimming
ドライヤー	drier
バスケ	basketball
バージン	virgin
ブルックナー	Bruckner
ラバー	lover
リーブ	leave
ウエット	wet
サミュエル	Samuel
ジャガー	jaguar
トラップ	trap
ビュッフェ	buffet
フランコ	Franco
ユング	Jung
ステートメント	statement
チャーム	charm
デカルト	Descartes
アニマル	animal
ジェスチャー	gesture
スターバックス	Starbucks
ゼミ	Seminar
テナー	tenor
ヘルニア	hernia
エストロゲン	estrogen
オムレツ	omelet
クローバー	clover
コテージ	cottage
スタンバイ	standby
ドラッグストアー	drugstore
バラード	ballade
ポリープ	polyp
ラメ	lame
リピーター	repeater
アスパラガス	asparagus
アナリスト	analyst
アルト	alto
アロー	arrow
アンドリュー	Andrew
エントランス	entrance
スピーディー	speedy
スライダー	slider
スワップ	swap
テック	technical
ラジカル	radical
ラッピング	wrapping
リソース	resource
オファー	offer
コナン	Conan
シビア	severe
スイミング	swimming
ソーラー	solar
チルドレン	children
ナイキ	Nike
パプリカ	paprika
フランクリン	Franklin
プログラマー	programmer
ペッパー	pepper
ボイラー	boiler
レポ	report
オペレーター	operator
マーキング	marking
マーラー	Mahler
キプロス	Cyprus
キャミソール	camisole
グラデーション	gradation
コロンブス	Columbus
サタン	Satan
サハリン	Sakhalin
シールド	shield
スチュアート	Stewart
ハーバー	harbor
ブローチ	brooch
マカロニ	macaroni
ライド	ride
ウインド	wind
コカイン	cocaine
シルビア	Silvia
ジャック	jack
ハイジャック	hijack
ファンデ	foundation
アキレス	Achilles
イート	eat
オーガズム	orgasm
カスタード	custard
クエスチョン	question
コンポーネント	component
チェルノブイリ	Chernobyl
ネービー	navy
ブローカー	broker
アクシデント	accident
アバウト	about
イザベル	Isabelle
エンブレム	emblem
クレンジング	cleansing
コックピット	cockpit
ジャンボ	jumbo
ドストエフスキー	Dostoevskii
エントロピー	entropy
ケインズ	Keynes
デービス	Davis
ネロ	Nero
フロラ	flora
ベジタリアン	vegetarian
リキッド	liquid
リキュール	liqueur
ロビンソン	Robinson
アバター	avatar
ウェールズ	Wales
エスニック	ethnic
オスカー	Oscar
オホーツク	Okhotsk
ギャラ	guarantee
ソマリア	Somalia
デラ	della
トリプル	triple
ハイパー	hyper
フリーズ	freeze
ブレーン	brain
メトロ	metro
ラング	langue
レトルト	retort
レフト	left
ワイヤレス	wireless
エトルリア	Etruria
ガラ	gala
スコープ	scope
テクニカル	technical
ディオール	Dior
ヒューマニズム	humanism
アルベルティーヌ	Albertine
シバ	Siva
タンカー	tanker
チャクラ	cakra
ホノルル	Honolulu
アスパラ	Asparagus
コルク	kurk
ビロード	veludo
フェミニン	feminine
ホップ	hop（跳躍）
モネ	Monet
ルージュ	rouge
エディション	edition
カルタ	carta
ガイア	Gaia
ガウン	gown
ショッキング	shocking
シーア	Shia
ピッチング	pitching
ペンシル	pencil
ホイル	foil
ミャンマー	Myanmar
ラッセル	Rasselgerausch
アイビー	ivy
グリッド	grid
テクノ	techno
ドン	don
フレームワーク	framework
マテリアル	material
ルター	Luther
ルビー	ruby
イブン	Ibn
エロチック	erotic
トラクター	tractor
トレース	trace
ドーン	dawn
ボンベ	Bombe
マニアック	maniac
ミニスカート	miniskirt
ミンチ	mince
メソポタミア	Mesopotamia
メチル	methyl
リチウム	Lithium
リミット	limit
ルース	Ruth
アマ	amateur
エキスパート	expert
キャスティング	casting
タール	tar
トー	toe
ハリケーン	hurricane
バント	bunt
ヒステリック	hysteric
ピリオド	period
ファイン	fine
ホワット	what
レスビアン	lesbian
イヤホン	earphone
インターフェロン	interferon
エコノミック	economic
カルト	cult
キウイ	kiwi
クロー	clos
コラボレーション	collaboration
サプリ	supplement
サロメ	Salome
シュミット	Schmitt
シンフォニー	symphony
ディス	this
ブラッシング	brushing
ボーン	bone
ポンス	pons
モア	more
イニシャル	initial
サッシ	sash
シューベルト	Schubert
ジョーン	Joan
スタイリッシュ	stylish
ダンベル	dumbbell
ビス	vis
ポリオ	polio
ポーク	pork
ムーブメント	movement
ラビ	rabbi
オーソドックス	orthodox
パラグアイ	Paraguay
パーキンソン	Parkinson
フレデリック	Frederick
マスコット	mascot
ウッズ	Woods
サハラ	Sahara
シャンデリア	chandelier
ハロン	halon
パラドックス	paradox
ファントム	phantom
フランチェスコ	Francesco
マーフィー	Murphy
ヤコブ	Jakob
ユーモラス	humorous
アッシュ	ash
カドミウム	cadmium
ギル	gill
グレーシー	Gracie
サウス	south
サラ	Sarah
チームワーク	teamwork
テーゼ	These
ハンナ	Hanna
プロローグ	prologue
モス	MOS
エイブラハム	Abraham
コンビネーション	combination
コーポレート	corporate
ジャスミン	jasmine
スタンフォード	Stanford
スロットル	throttle
デトロイト	Detroit
ドリブル	dribble
ベック	Beck
ボリビア	Bolivia
マルセイユ	Marseille
マンチェスター	Manchester
レジスト	resist
コネクション	connection
ゴンドラ	gondola
シャム	Siam
チック	#ИМЯ?
アンペア	ampere
キャブ	cab
ケルン	Koln
セレスト	Celeste
ドナルド	Donald
ナイス	nice
フィル	Philharmonie
ペスタロッチ	Pestalozzi
ポリエステル	Polyester
マタイ	Maththaios
マーガリン	margarine
レプリカ	replica
アルフレッド	Alfred
エージェンシー	agency
オンブズマン	ombudsman
オーシャン	ocean
グラ	gras
ゴースト	ghost
セラミック	ceramic
タイラー	Tylor
ダスト	dust
ファウスト	Faust
フライド	fried
プロポーション	proportion
ヘロイン	Heroin
マリネ	marine
ミュール	mule
ミル	Mill
リニア	linear
アクト	act
アッパー	upper
アムステルダム	Amsterdam
アンダーソン	Anderson
ガーリック	garlic
コープ	coop
ダックス	Dachshund
チャーター	charter
バイエルン	Bayern
ブルゾン	blouson
ペギー	Peguy
ルノー	Renault
アイシャ	Aisha
ウォーカー	walker
デーブ	Dave
ハイドン	Haydn
バザール	bazar
ヒア	here
フェノール	phenol
マルタ	Malta
ラプソディー	rhapsody
ロジスティック	logistic
ワンダー	wonder
アップロード	upload
アリア	aria
アリラン	arirang
ウエルカム	welcome
エンゲルス	Engels
シュメール	Sumer
ステッキ	stick
セロハン	cellophane
ディスクロージャー	disclosure
トルーマン	Truman
ハプニング	happening
ボルドー	Bordeaux
カーン	Khan
キャディー	caddie
ケンタッキー	Kentucky
コンテキスト	context
ジューシー	juicy
スポットライト	spotlight
セーフガード	safeguard
ダイブ	dive
トイ	toy
トラベル	travel
フランチャイズ	franchise
ブローデル	Braudel
ポートレート	portrait
ラスベガス	Vegas
ラボ	laboratory
アプリ	application
アワー	hour
インターチェンジ	interchange
カーキ	khaki
コンプリート	complete
ゴア	Goa
ダル	dull
バンキング	banking
パラ	para
フィーリング	feeling
ブラックリスト	blacklist
プロット	plot
マヤ	Maya
ラス	lath
リバプール	Liverpool
アライアンス	alliance
ショールーム	showroom
スク	schooling
スクリーニング	screening
ストロベリー	strawberry
チャージ	charge
チームメート	teammate
デュアル	dual
ヒステリー	Hysterie
フィジー	Fiji
フリードリヒ	Friedrich
ブリキ	blik
プランナー	planner
ヘラクレス	Herakles
ヘルメス	Hermes
ボーイング	Boeing
マーガレット	Marguerite
ランス	Reims
リズミカル	rhythmical
レシート	receipt
ローランド	Rowland
アソシエーション	association
エス	Es
エチオピア	Ethiopia
チーク	cheek
バラモン	brahmana
フィリップス	Philips
プラネタリウム	Planetarium
マイノリティー	minority
モーメント	moment
スマトラ	Sumatra
ソード	sword
ハイジ	Heidi
バイオレット	violet
パッチワーク	patchwork
フレディー	Freddie
フローラル	floral
ブイ	buoy
モノレール	monorail
アウトライン	outline
サイレンサー	silencer
サーファー	surfer
スルタン	sultan
ダイ	dye
ダクト	duct
ダンピング	dumping
チワワ	Chihuahua
ノウ	know
ハウ	how
パラグラフ	paragraph
プロファイル	profile
マンガン	Mangan
ユーゴー	Hugo
ユーラシア	Eurasia
ランタン	lantern
エコノミスト	economist
コスプレ	costume play
コリア	Korea
スコップ	schop
スプリント	sprint
ソー	saw
チェス	chess
ツイード	tweed
ドバイ	Dubai
ハンティング	hunting
バイオマス	biomass
ホルン	horn
マスタード	mustard
ミニマム	minimum
ラムネ	lemonade
リンス	rinse
ルビ	ruby
ウェーバー	Weber
エアロビック	aerobic
エンタープライズ	enterprise
クラクション	klaxon
シーフード	seafood
バンカー	bunker
フランソワ	Francois
フー	who
ホームステイ	homestay
ホールド	hold
マットレス	mattress
ユーティリティー	utility
ランドセル	ransel
リンチ	Lynch
ロイター	Reuters
ロケーション	location
ローガン	Logan
エミール	Emile
エンコード	encode
オペ	operation
カシミア	cashmere
グレゴリー	Gregory
サイゴン	Saigon
サプライズ	surprise
サンパウロ	Sao Paulo
ジンジャー	ginger
スキップ	skip
スロープ	slope
ディエゴ	Diego
ハンドメード	handmade
バージニア	Virginia
フラメンコ	flamenco
ペンション	pension
ボスニア	Bosnia
ミリタリー	military
アーノルド	Arnold
ギルド	guild
グロテスク	grotesque
コサージュ	corsage
コンポ	component
ゴーグル	goggle
バーボン	bourbon
パトロン	patron
パーカー	Parker
フィラデルフィア	Philadelphia
ブリュッセル	Bruxelles
マンネリ	mannerism
ユーゴ	Yugoslavia
エドガー	Edgar
グラム	Gram
コミットメント	commitment
サバンナ	savanna
シェ	chez
スパン	span
スピードアップ	speed-up
タイツ	tights
タラ	Tara
ネクスト	next
ノンノ	non-no
ハイツ	heights
バーナード	Bernard
ピック	pick
ヘミングウェー	Hemingway
ラマ	lama
レトリック	rhetoric
ゲレンデ	Gelande
サニー	sunny
テレコム	telecom
パナマ	Panama
マンモス	mammoth
ユダ	Judas
エッセンシャル	essential
クライン	klein
クラッカー	cracker
サテン	satin
セクシャリティー	sexuality
ダブルス	doubles
ニート	NEET
ハディース	hadith
バウハウス	Bauhous
リコール	recall
アトランタ	Atlanta
コバルト	cobalt
ゴーギャン	Gauguin
シャボン	sabao
シーザー	Caesar
スモッグ	smog
スーパースター	superstar
ダンカン	Duncan
デマ	Demagogie
トリップ	trip
トレンチ	trench
パフェ	parfait
フォール	fall
ブロードウェー	Broadway
ヘリウム	helium
ミリオン	million
ジェリー	Jerry
スペア	spare
デュマ	Dumas
ニス	varnish
ベニス	Venice
リムジン	limousine
ルシアン	Lucien
レンダリング	rendering
ウイグル	Uighur
オリンピア	Olympia
ジャカルタ	Djakarta
ダ	da/de
ヒーリング	healing
フィッシャー	Fisher
ロイド	Lloyd
アボカド	avocado
キャプチャー	capture
クリエーター	creator
クーペ	coupe
サス	suspension
サッチャー	Thatcher
ザット	that
ジョージア	Georgia
ダルタニアン	D'Artagnan
チョーク	chalk
ビルヘルム	Wilhelm
フレンドリー	friendly
ブザー	buzzer
ブランク	blank
プロレタリア	Proletarier
ボードレール	Baudelaire
イザヤ	Isaiah
エキゾチック	exotic
クラ	clarinet
サイモン	Simon
ジュ	je
セーヌ	Saine
ソール	sole(魚)
トライアル	trial
ノストラダムス	Nostradamu
ハンブルク	Hamburg
フェロモン	pheromone
ベネトン	Benetton
ミューラー	Muller
ワルシャワ	Warszawa
アドビ	Adobe
カウボーイ	cowboy
ギルバート	Gilbert
サーフ	surf
シャトー	chateau
スネイプ	Snape
ソサエティー	society
ターナー	Turner
ネーション	nation
バックス	backs
バッチ	batch
バルカン	Balkan
パージ	purge
ファジー	fuzzy
モダニズム	modernism
リム	rim
レスト	rest
アボリジニ	aborigine
インサイダー	insider
オットー	Otto
オピニオン	opinion
コロン	cologne
ネイサン	Nathan
フーコー	Foucault
プリーツ	pleats
プロテイン	protein
ペチカ	pechka
ホイップ	whip
マグニチュード	magnitude
リアクション	reaction
リピート	repeat
ロボ	robot
ローブ	robe
ワイパー	wiper
アンドレイ	Andrei
イニング	inning
ウィー	we
オカルト	occult
オリジナリティー	originality
オーロラ	aurora
カステラ	Castella
サックス	sax
ステンド	stained
ストックホルム	Stockholm
スパム	spam
スペル	spell
ニア	near
ニュートラル	neutral
ハルビン	Harbin
パスカル	Pascal
ピロリ	pylori
フュージョン	fusion
ブルドーザー	bulldozer
ブレス	breath
ベネズエラ	Venezuela
ベンゼン	benzene
ポー	Poe
ミディアム	medium
メーキング	making
インスピレーション	inspiration
ギタリスト	guitarist
クエスト	quest
クラウス	Klaus
シーボルト	Siebold
スエード	suede
センサス	census
デジ	digital
ハムレット	Hamlet
バウンド	bound
フェラ	fellatio
マタニティー	maternity
ムッソリーニ	Mussolini
リネン	linen
レクチャー	lecture
アスベスト	Asbest
アロマセラピー	aromatherapy
クエンティン	Quentin
ケミカル	chemical
コンベヤー	conveyor
スノーボード	snowboard
ツモ	自摸
バカンス	vacances
ロジック	logic
アップグレード	upgrade
アレキサンドル	Alexander
カーネギー	Carnegie
キセル	khsier
ジョブ	job
スコッチ	Scotch
スパイダー	spider
スポーツマン	sportsman
スー	四
ソリューション	solution
ドロー	draw
ハラスメント	harassment
ペイ	pay
メタリック	metallic
レジストリー	registry
エレキ	electriciteit
カウントダウン	countdown
ガリ	Ghali
キャバレー	cabaret
コレラ	cholera
シャーマン	shaman
ジグザグ	zigzag
ジョッキ	jug
トール	tall
パパイア	papaya
フィン	fin
メロ	melody
レジスタンス	resistance
アウター	outer
アルミホイル	aluminium foil
イフ	if
クロウ	crow
コルト	Colt
コンマ	comma
チェックアウト	check-out
テリトリー	territory
ディー	Dee
トロッコ	truck
ドレーン	drain
ビオラ	viola
フォワード	forward
ペスト	pest
メープル	maple
モニュメント	monument
モーテル	motel
アイリス	iris
エマ	Emma
オルゴール	orgel
キャッシング	cashing
キャリー	carry
ジニ	Gini
トロント	Toronto
ハンディキャップ	handicap
ヒラリー	Hillary
フィンガー	finger
ヘンデル	Handel
リラクセーション	relaxation
レイ	lay
レーズン	raisin
アウトソーシング	outsourcing
アドベンチャー	adventure
イクラ	ikra
インフォームド	informed
エバー	ever
オフセット	offset
オマーン	Oman
カンヌ	Cannes
クレオパトラ	Kleopatra
サイレンス	silence
スランプ	slump
チロル	Tyrol
ディック	Dick
デーモン	demon
ナント	Nantes
ハッスル	hustle
バンクーバー	Vancouver
パラソル	parasol
ブラント	Brandt
プランニング	planning
ヘイ	hey
ホッケー	hockey
メシア	Messiah
モンキー	monkey
レッグ	leg
アプレット	applet
エクアドル	Ecuador
グライダー	glider
コークス	Koks
サイダー	cider
ショーン	Sean
タペストリー	tapestry
チェイス	chase
トゥルー	TRUE
ハワイアン	Hawaiian
パンジー	pansy
フィルハーモニー	Philharmonie
マリノ	marinos
ライク	like
リヨン	Lyon
ワイマール	Weimar
ワンピ	one-piece
アンソニー	Anthony
エスコート	escort
カスティリャ	Castilla
コイ	coi
サブリナ	Sabrina
スターター	starter
スペシャリスト	specialist
スリット	slit
ダイナマイト	dynamite
トレール	trail
バルーン	balloon
パイク	pike
パラレル	parallel
ビクター	victor
ビラ	villa
ビーカー	beaker
ブランチ	branch
プランクトン	plankton
マヨ	mayonnaise
ミシガン	Michigan
ミーガン	Megan
ルポ	reportage
ルーキー	rookie
アルバニア	Albania
カルメン	Carmen
カレント	current
クラリネット	clarinet
クロアチア	Croatia
シャーベット	sherbet
ステラ	Stella
ダック	duck
テロリズム	terrorism
テークアウト	take-out
デシリットル	decilitre
ヘルペス	herpes
ペテロ	Petros
ホスピス	hospice
ポプラ	poplar
メット	met
エチケット	etiquette
サージ	serge
スイ	Sui
デコレーション	decoration
デフレーター	deflator
ハナ	hana
ハミルトン	Hamilton
バクテリア	bacteria
ヒスタミン	histamine
フェーズ	phase
フォーミュラ	formula
フレア	flare
ベルナール	Bernard
リーディング	leading
ローズマリー	rosemary
アウシュビッツ	Auschwitz
アド	ad
アナル	anal
オクターブ	Oktave
オンワード	onward
コリント	Corinth
スパイラル	spiral
セーバー	saver
ダース	Darth
バチカン	Vatican
バルザック	Balzac
フィットネス	fitness
フライング	flying
フロート	float
プロバンス	Provence
ホリデー	holiday
マカオ	Macao
マッチング	matching
マルセル	Marcel
メレディス	Meredith
ヤハウェ	Yahweh
ユニバーシティー	university
ランゲージ	language
アイリーン	Aileen
アルカイダ	al-qaida
エクイティー	equity
エポック	epoch
スツール	stool
ニューオーリンズ	New Orleans
ネイト	Nate
ネルソン	Nelson
バーディー	birdie
ヒッピー	hippie
ピューレ	puree
マイヤー	Mayer
メコン	Mekong
モンロー	Monroe
ユタ	Utah
リュックサック	rucksack
カロチン	carotene
キルト	quilt
クーパー	Cooper
コスモ	cosmo
ゴーン	Ghosn
ジャスダック	Jasdaq
ディスカウント	discount
ナレッジ	knowledge
ヒスパニック	Hispanic
ビクトール	Viktor
ベルガー	Berger
ロジャース	Rodgers
アーセナル	arsenal
インディー	indie
ウイークリー	weekly
エセックス	Essex
チャペル	chapel
トリ	tri
ノズル	nozzle
ハグリッド	Hagrid
バリケード	barricade
ミシシッピ	Mississippi
ユークリッド	Euclid
ランドマーク	landmark
ルドルフ	Rudolf
レセプション	reception
アポトーシス	apoptosis
オイスター	oyster
コミンテルン	Komintern
サド	sadist
サンキュー	thank you
ダイジェスト	digest
チェコスロバキア	Czecho-Slovakia
ツイスト	twist
ツーリズム	tourism
トレッキング	trekking
ドライビング	driving
ハイヤー	higher
ビルディング	building
ファシスト	fascist
プロパン	Propan
ボイコット	boycott
ラジエーター	radiator
リーク	leak
アクセ	accessory
アム	am
アラーム	alarm
キホーテ	Quijote
グリア	glia
コサイン	cosine
コンパイル	compile
シリアス	serious
ジェノバ	Genova
ジプシー	gypsy
チューリヒ	Zurich
フェリックス	Felix
フーリエ	Fourier
ブラス	brass
モラトリアム	moratorium
ライフライン	lifeline
ラビット	rabbit
レガシー	legacy
レズ	Lesbian
アポ	appointment
イージス	aegis
ウラジオストク	Vladivostok
クライスラー	Kreisler
コサック	Cossack
シッター	sitter
スタンダール	Stendhal
ダッチ	Dutch
ダライラマ	Dalai Lama
テーブルクロス	tablecloth
ハイド	hyde
バゲット	baguette
バックグラウンド	background
パテ	putty
ブリジストン	BRIDGESTONE
プロパガンダ	propaganda
マクベス	Macbeth
マロン	marron
メルヘン	Marchen
レックス	Rex
ロダン	Rodin
ローレンツ	Lorentz
イズム	ism
インスタンス	instance
ウォーホル	Warhol
エルム	elm
ギガ	giga
クオーター	quarter
クック	Cook
ザビエル	Xavier
シーリング	ceiling
スクラム	scrum
ゾンビ	zombie
ゾーイ	zoe
ダンパー	damper
トルストイ	Tolstoi
ニコロ	Niccolo
バイヤー	buyer
バーテンダー	bartender
ブルジョアジー	bourgeoisie
プロシージャー	procedure
マネキン	mannequin
マリファナ	marijuana
マンパワー	manpower
ラージ	large
ロココ	rococo
ワープ	warp
カスタマー	customer
カーゴ	cargo
グルタミン	glutamine
コンファレンス	conference
ザルツブルク	Salzburg
ゾラ	Zola
トリスタン	Tristan
ハー	her
バスタブ	bathtub
バッシング	bashing
パウエル	Powell
ビジター	visitor
フォート	fort
マシュー	Matthew
モナコ	Monaco
モノトーン	monotone
ロスト	lost
アロハ	aloha
アンデス	Andes
エイリアン	alien
エグザイル	exile
エジソン	Edison
エンジョイ	enjoy
ガイダンス	guidance
ケルト	Celt
シャーリー	Shirley
ジッパー	zipper
スキンシップ	skinship
ドッキング	docking
バビロニア	Babylonia
バラック	barrack
ブルゴーニュ	Bourgogne
ベルディ	Verdy
ミトコンドリア	mitochondria
ウェイン	Wayne
クリトリス	clitoris
グリム	Grimm
コンソール	console
サクセス	success
スパイシー	spicy
トロール	trawl
ドメスティック	domestic
パウル	Paul
ビスマルク	Bismarck
フィー	fee
ブースター	booster
マーブル	marble
メルボルン	Melbourne
リサイタル	recital
アクロバット	acrobat
アセット	asset
アーバン	urban
オニオン	onion
オリンパス	Olympus
カストロ	Castro
カムフラージュ	camouflage
キャラバン	caravan
コーエン	Cohen
サイトカイン	cytokine
サンシャイン	sunshine
シネ	cinema
セビリア	Sevilla
セレクション	selection
トリノ	Torino
マニフェスト	manifesto
エーテル	ether
キャミ	camisole
クララ	Clara
コンミューン	commune
ゴシップ	gossip
シューマン	Schumann
タナー	Tanner
テスター	tester
デュエット	duet
ニューマン	Newman
ネバー	never
ノード	node
フォア	foie
ブリーダー	breeder
ホフマン	Hoffmann
ミラクル	miracle
リベート	rebate
ロレンソ	Lorenzo
アルバート	Albert
アンチョビー	anchovy
インテーク	intake
インデント	indent
コブラ	cobra
シューマッハー	Schumacher
ストリップ	strip
スラグ	slag
タックス	tax
ダイムラー	Daimler
トリストラム	Tristram
ハイドロ	hydro
ハーグ	Haag
バタフライ	butterfly
バリウム	barium
ピンセット	pincette
ミット	mitt
ラズベリー	raspberry
リザーブ	reserve
レスキュー	rescue
アイスランド	Iceland
アストロ	astro
オフサイド	offside
キャッスル	castle
ダンディー	dandy
ハレム	harem
ハンドリング	handling
ヒレ	filet
ベア	base up
ベレー	beret
ラブリー	lovely
ワーム	worm
アドバンス	advance
アパッチ	Apache
アングロサクソン	Anglo-Saxon
コミッション	commission
コモン	common
コルホーズ	kolkhoz
ジン	gin
ターム	term
テロップ	telop
ハイビスカス	hibiscus
バビロン	Babylon
バルク	bulk
バーレーン	Bahrain
フェチ	fetishism
フライデー	Friday
フリント	flint
ペニー	penny
メディチ	Medici
リオン	RION
ワイングラス	wineglass
アトランティス	Atlantis
インプラント	implant
エジンバラ	Edinburgh
エネルギッシュ	Energisch
カンジダ	candida
カートリッジ	cartridge
コソボ	Kosovo
コロナ	corona
コンゴ	Congo
コールド	called
スパルタ	Sparta
ソン	son
タイプライター	typewriter
タヒチ	Tahiti
テクスチャー	texture
デラックス	deluxe
ドナウ	Donau
パビリオン	pavilion
ヒューズ	Hughes
ピクルス	pickles
プールサイド	poolside
ベンガル	Bengal
マザコン	mother complex
メモリアル	memorial
メーソン	mason
インピーダンス	impedance
カザフスタン	Kazakhstan
キケロ	Cicero
キャバクラ	cabaret club
クチュール	couture
クロムウェル	Cromwell
グラフィティー	graffiti
シリング	shilling
セザンヌ	Cezanne
センテンス	sentence
ダグラス	Douglas
トタン	tutanaga
ニュルンベルク	Nurnberg
ハーバート	Herbert
パイン	pine
ヘモグロビン	hemoglobin
ミチル	Myltyl
ルクセンブルク	Luxembourg
ルーチン	routine
アバンギャルド	avantgarde
アリゾナ	Arizona
アーリー	early
カローラ	Corolla
コーチング	coaching
サドル	saddle
サファイア	sapphire
ショール	shawl
スプレッド	spread
スンナ	Sunnah
ソニック	sonic
ソムリエ	sommelier
チュニジア	Tunisia
ノーザン	northern
バイス	vice
パター	putter
ホセ	Jose
ポーカー	poker
モントリオール	Montreal
リスニング	listening
リテラシー	literacy
リージョン	region
レクサス	lexus
ロドリゲス	Rodriguez
アシュリー	Ashley
アニマ	anima
アメニティー	amenity
アロエ	aloe
エクスタシー	ecstasy
エバンズ	Evans
エレクトリック	electric
オブザーバー	observer
カカオ	cacao
キックオフ	kick-off
サンライズ	sunrise
サーベイ	survey
スレッド	thread
トリュフ	truffe
ナイーブ	naive
ニカラグア	Nicaragua
ハウジング	housing
ハーモニカ	harmonica
ベアリング	bearing
ペースメーカー	pacemaker
ボンベイ	Bombay
マイスター	Meister
マルコス	Marcos
メリル	Merrill
ロイス	Royce
アイソトープ	isotope
アカデミック	academic
アスレチック	athletic
アドリブ	ad lib
アラート	alert
アレキサンドリア	Alexandria
イーサーネット	Ethernet
ウインター	winter
エルフ	Elf
カフ	cuff
ギネス	Guinness
ギプス	Gips
グレース	grace
コンバーター	converter
スクランブル	scramble
フットワーク	footwork
ブルックリン	Brooklyn
ペパーミント	peppermint
ホールディング	holding
ホールデン	Holden
リスナー	listener
ルディ	Rudi
ルーメン	lumen
レオポルド	Leopold
ローリング	rolling
ウレタン	urethan
カノン	cannon
ガバメント	government
コスチューム	costume
コレ	collection
サンバ	samba
シャンソン	chanson
テーピング	taping
バレリーナ	ballerina
ブレッド	bread
プリペイド	prepaid
ミッドウェー	Midway
モルト	malt
レシーブ	receive
レセプター	receptor
ロト	Lot
アイゼン	Steigeisen
アウトプット	output
アジェンダ	agenda
アタッシュ	attache
イゾルデ	Isolde
エブリー	every
カウル	cowl
カービング	carving
クルーザー	cruiser
ケプラー	Kepler
コペンハーゲン	Copenhagen
コラージュ	collage
センセーショナル	sensational
ソート	sort
ノスタルジア	nostalgia
パラシュート	parachute
フランドル	Flandre
フレキシブル	flexible
ブダペスト	Budapest
ブーイング	booing
プレジデント	president
ヘルシンキ	Helsinki
モルタル	mortar
ラッテ	latte
レイナ	Reyna
ウルリヒ	Ulrich
エホバ	Jehovah
オハイオ	Ohio
カリフラワー	cauliflower
クレージー	crazy
コンチネンタル	continental
ジャンクション	junction
トランクス	trunks
トロツキー	Trotskii
ビトゲンシュタイン	Wittgenstein
フィール	feel
フラスコ	frasco
フリーク	freak
マンスフィールド	Mansfield
メダリスト	medalist
メドレー	medley
メーラー	mailer
レオニ	Leoni
ローダー	Lauder
ウインカー	winker
エアゾール	aerosol
カフェオレ	cafe au lait
カンガルー	kangaroo
キメラ	chimera
ゴスペル	gospel
ジョイ	joy
スパー	spur
スワン	swan
ダンテ	Dante
トモ	Tomo
トラス	truss
トラフィック	traffic
ナイジェリア	Nigeria
ナイター	nighter
パスコー	Pascoe
ビスタ	vista
フィナーレ	finale
フェミニスト	feminist
フリマ	flea market
ブレザー	blazer
ブート	boot
プエルトリコ	Puerto Rico
プードル	poodle
ヘル	Herr
ベニヤ	veneer
ペニシリン	penicillin
ポジショニング	positioning
ポリエチレン	Polyathylen
ポルト	Porto
マイアミ	Miami
ミルトン	Milton
モカ	mocha
リバイバル	revival
レンブラント	Rembrandt
ロマ	Roma
アレジ	Alesi
イントネーション	intonation
エグゼクティブ	executive
エスキモー	Eskimo
カフカ	Kafka
クラシカル	classical
サンスクリット	Sanskrit
シス	Sith
シャン	Schon
ジャマイカ	Jamaica
スチーム	steam
ストリング	string
ストロング	strong
セバスチャン	Sebastian
トゥモロー	tomorrow
ヌードル	noodle
ノックアウト	knock-out
バース	Barth
フォーメーション	formation
ホロ	Jolo
マイクログラム	microgram
ヤー	ja
イブニング	evening
インカ	Inca
インパルス	impulse
ウルフ	wolf
エ	et
エージング	aging
オプショナル	optional
オペレッタ	operetta
オードブル	hors d'oeuvrehors d'oeuvre
カーネーション	carnation
サフラン	saffraan
セミ	semi-
ダリ	Dali
チェッカー	checker
ナム	number
ピーチ	peach
フリース	fleece
フーガ	fuga
ブライダル	bridal
プラクティス	practice
プレタ	pret-a
マルフォイ	Malfoy
ミケランジェロ	Michelangelo
メレンゲ	meringue
ワースト	worst
アニータ	Anita
イージー	easy
コアラ	koala
コンパニオン	companion
スクラブ	scrub
テヘラン	Teheran
テリア	terrier
ドラクロワ	Delacroix
バロン	baron
バーミングハム	Birmingham
ビオトープ	biotope
ヘップバーン	Hepburn
ベーカー	Baker
ペドロ	Pedro
ボルボ	VOLVO
ムッシュー	monsieur
ライフワーク	lifework
アフィリエート	affiliate
エピローグ	epilogue
オーウェン	Owen
カップリング	coupling
コンパ	company
シュール	surrealisme
セネガル	Senegal
チョッキ	jaque
トレードマーク	trademark
ドーパミン	dopamine
ハッカー	hacker
ハンソン	Hanson
ヒアルロン	hyaluronic acid
ビビッド	vivid
ビーコン	beacon
ブイヨン	bouillon
ホビー	hobby
リトアニア	Lithuania
リリーフ	relief
レゲエ	reggae
アガリクス	agaricus
エチレン	Athylen
カモミール	chamomile
クレソン	cresson
ジェイミー	Jamie
ストーム	storm
チャーチル	Churchill
チャーミング	charming
ティーンエージャー	teenager
デリバリー	delivery
ハック	Hack
バスローブ	bathrobe
パルチザン	partisan
ビネガー	vinegar
フィフティー	fifty
フェード	fade
ベーキング	baking
ボヘミア	Bohemia
リソソーム	lysosome
ロックフェラー	Rockefeller
ローマン	Roman
アシュレー	Ashley
アジト	agitating point
アベニュー	avenue
イスタンブール	Istanbul
エベレスト	Everest
カブール	Kabul
ジョッキー	jockey
スケッチブック	sketchbook
ストライカー	striker
ディッシュ	dish
デビル	devil
デモンストレーション	demonstration
トリガー	trigger
バロメーター	barometer
ビバ	viva
フェリペ	Felipe
プレミア	premier
プロモーター	promoter
ポルテ	porter
マニ	mani
モル	mol
モース	Morse
モータリゼーション	motorization
ラーニング	learning
アベ	Ave
アレルゲン	allergen
イスパニア	Espana
クラン	clan
グローバリズム	globalism
サテライト	satellite
サンダー	sander
ショーケース	showcase
シーソー	seesaw
ジップ	zip
スタン	stun
ストラト	strato
スピッツ	Spitz
セフレ	sex friend
ツァーリ	tsar
ディル	dill
デコ	deco
デベロッパー	developer
ハーネス	harness
パフューム	perfume
フランシスコ	Francisco
プリズム	prism
マントル	mantle
マンホール	manhole
ミスマッチ	mismatch
ユーカリ	eucalyptus
ライプチヒ	Leipzig
ルソン	Luzon
アドレナリン	adrenaline
オートマチック	automatic
カミング	coming
キナーゼ	kinaze
グラント	Grant
グーテンベルク	Gutenberg
コンパートメント	compartment
サバ	Sabah
サファリ	safari
スケルトン	skeleton
スタック	stack
スタンディング	standing
スピリチュアル	spiritual
スポイラー	spoiler
タンザニア	Tanzania
ディベロップメント	development
ナッシュ	Nash
ハンドブック	handbook
バーテン	bartender
フアナ	Juana
ベゴニア	begonia
ベネディクト	Benedict
ホワイル	while
ポーロ	Polo
マンハイム	Mannheim
モンテ	monte
モーターボート	motorboat
レボリューション	revolution
アカシア	Acacia
アニ	Ani
アルザス	Alsace
ウル	Ur
エイド	aid
カッティング	cutting
クリティカル	critical
ゲシュタポ	Gestapo
シアン	cyan
スエズ	Suez
スモーカー	smoker
スラックス	slacks
スリーブ	sleeve
テムズ	Thames
デパ	department
トリビア	trivia
ドラ	draft
ニコル	Nicolle
ハウンド	hound
バイロン	Byron
バンプ	bump
ブレーカー	breaker
プレハブ	prefab
ペナント	pennant
ペール	Peer
ポニー	Pony
マッチョ	macho
マロリー	Malory
ミクロン	micron
リミテッド	limited
レノン	Lennon
レーティング	rating
アコースティック	acoustic
ウェンディ	Wendy
ウズベキスタン	Uzbekistan
エグゾースト	exhaust
カイン	Cain
カーライル	Carlyle
クエーサー	quasar
グリース	grease
グレリン	ghrelin
ケープ	Cape
サリバン	Sullivan
サワー	sour
サンクス	thanks
ジャブ	jab
スピノザ	Spinoza
ズッキーニ	zucchini
タキシード	tuxedo
ナビゲーション	navigation
ノーズ	nose
パッキン	packing
フェーク	fake
プノンペン	Phnompenh
プラネット	planet
ペーター	Pater
ポリネシア	Polynesia
ヨード	Jod
ランドリー	laundry
レビ	Levi
レーク	lake
ロードスター	roadster
ワイフ	wife
ワンダフル	wonderful
アーメン	amen
イントロ	introduction
ウィキ	wiki
エンペラー	emperor
オズワルド	Oswald
カブ	cub
カリフ	caliph
サイクロン	cyclon
スリリング	thrilling
タタール	Tatar
チャンピオンシップ	championship
ティーン	teen
ハリソン	Harrison
ハンチントン	Huntington
バーンズ	Burns
パラフィン	paraffin
パルマ	Palma
フィジカル	physical
プレゼンス	presence
ボランチ	volante
ポピー	poppy
ミシュラン	Michelin
レイズ	raise
ロベール	Robert
ローリー	Raleigh
アンドロメダ	Andromeda
イエメン	Yemen
ウォーミング	warming
エクスポート	export
オセロ	othello
カルマ	karma
キャンピング	camping
ジョゼフィーヌ	Josephine
ストッパー	stopper
タイタニック	titanic
テネシー	Tennessee
デフラグ	defragmentation
ノンバンク	nonbank
バインダー	binder
バレンシア	Valencia
バーク	Bark
パンフ	pamphlet
ヒューム	Hume
ブレジネフ	Brezhnev
ヘリコバクター	helicobacter
ペル	per
ホステル	hostel
マキアベリ	Machiavelli
ムートン	mouton
リゾット	risotto
ロブ	lob
ロートレック	Lautrec
アルファロメオ	Alfa Romeo
インフォ	info
グリセリン	glycerin
コラリー	Coralie
サイドカー	sidecar
サウジ	Saudi
サンディー	Sandy
ソリッド	solid
デリー	Delhi
トレント	Torrent
トロフィー	trophy
ニッチ	niche
ニース	Nice
バンダナ	bandanna
ピペット	pipette
ピューリタン	Puritan
ファンダメンタル	fundamental
フラップ	flap
フリードマン	Friedman
ブルターニュ	Bretagne
プレストン	Preston
プロンプト	prompt
プローブ	probe
ペソ	peso
ペテルブルク	Peterburg
ボア	boa
マッド	mad
ミカエル	Michael
メタノール	Methanol
モンタージュ	montage
ライル	Ryle
リルケ	Rilke
レンチ	wrench
イラストレーション	illustration
エンゾ	Enzo
エーカー	acre
キエフ	Kiev
クリアランス	clearance
クロワッサン	croissant
コリアン	Korean
コルセット	corset
シーニュ	signe
スカルノ	Sukarno
スネーク	snake
セス	Seth
ゼラニウム	geranium
ゼロックス	Xerox
ソウル	soul
ハインリヒ	Heinrich
ハレルヤ	hallelujah
バイブル	Bible
ピラフ	pilaf
フロイド	Floyd
プレゼン	presentation
ベッキー	Becky
ベーグル	bagel
ホプキンス	Hopkins
ホーガン	Hogan
ポリゴン	polygon
マミー	mammy
ミネルバ	Minerva
ルーン	rune
レイノルズ	Reynolds
ロスチャイルド	Rothschild
アルメニア	Armenia
イコン	Ikon
インフラストラクチャー	infrastructure
ウイット	wit
エリカ	Erika
オリエンテーション	orientation
カトマンズ	Katmandu
キッシンジャー	Kissinger
クライド	Clyde
ゲットー	ghetto
シモンズ	Symonds
スケープ	scape
セピア	sepia
センチメンタル	sentimental
テーラー	tailor
ディーナ	Dina
デリート	delete
デーン	Dane
トミカ	Tomica
バイブ	vibes
パドック	paddock
ビリヤード	billiards
ベイルート	Beirut
ペルソナ	persona
マイカル	MYCAL
マッピング	mapping
ユリウス	Julius
ロティ	Loti
アウディ	Audi
ウラル	Ural
エクスペリエンス	experience
カルカッタ	Calcutta
カンザス	Kansas
クロロフィル	chlorophyl
グラマン	Grumman
グロブリン	globulin
ゲー	game
コンスタント	constant
コーデック	codec
スティグリッツ	Stiglitz
セム	Sem
ダイナミズム	dynamism
チャップリン	Chaplin
テトラ	tetra
ディートリヒ	Dietrich
パティシエ	patissier
パーシー	Percy
フェデラル	federal
フェラチオ	fellatio
プロトタイプ	prototype
ベルベット	velvet
ベーダ	veda
マダガスカル	Madagascar
メタファー	metaphor
モーリー	Maury
ラテックス	latex
ロイヤリティー	royalty
アイアイ	aye aye
アスピリン	Aspirin
アミン	amine
エープリル	April
オーナメント	ornament
オーラル	oral
カエサル	Caesar
カフェテリア	cafeteria
キャビア	caviar
クレタ	Creta
グロス	gross
ケースワーカー	caseworker
コメンテーター	commentator
サーベイランス	surveillance
シェルター	shelter
ジャグジー	Jacuzzi
スカル	scull
タラップ	trap
タートル	turtle
チェチェン	Chechen
ハイカラ	high collar
パークス	Parks
パーセンテージ	percentage
パーム	palm
ヒエラルキー	hierarchy
ビルド	build
ファセット	facet
ベルク	Berg
マイコン	microcomputer
マラ	mara
ラバ	lava
リラ	lilas
アナキン	Anakin
アベル	Abel
イエット	yet
インダストリー	industry
エアライン	airline
エキサイト	excite
カレル	Karlova
ガーナ	Ghana
キーパー	keeper
クリーミー	creamy
グアテマラ	Guatemala
コクトー	Cocteau
コスタリカ	Costa Rica
コロラド	Colorado
シングルス	singles
スクワット	squat
スコール	squall
チェンバロ	cembalo
ティーチング	teaching
バイオリニスト	violinist
バーバリー	Burberry
フレーク	flake
プロジェクター	projector
ヘロドトス	Herodotos
ポップコーン	popcorn
メーリング	mailing
リヒター	Richter
ロレックス	Rolex
アソシエート	associate
アトール	atoll
アベック	avec
アメーバ	Amobe
アンヌ	Anne
ウースター	Worcester
エゴイズム	egoism
エッフェル	Eiffel
カールトン	Carlton
クリーブランド	Cleveland
コルトレーン	Coltrane
コーネル	Cornell
ジャポニカ	japonica
ジュドー	Judau
スキーヤー	skier
スポーク	spoke
セラ	sera
チャイコフスキー	Chaikovskii
デバッグ	debug
ナイアガラ	Niagara
パル	pal
プレジャー	pleasure
ヘルマン	Hermann
ポリフェノール	polyphenol
マケドニア	Macedonia
ミッド	mid
ウォレット	wallet
キャパ	capacity
クラブハウス	clubhouse
コミカル	comical
シャンパーニュ	Champagne
ストレッチング	stretching
ダラス	Dallas
チャイニーズ	Chinese
ツーリスト	tourist
トランスファー	transfer
トレーサー	tracer
トロピカル	tropical
ノエ	Noe
ノーマリゼーション	normalization
ハロゲン	Halogen
バルサ	balsa
バーツ	baht
ビギナー	beginner
ビューティフル	beautiful
ブルガリ	Bulgari
ブースト	boost
プシュケー	psykhe
ベンダー	vendor
ベーカリー	bakery
ボイル	boil
ユベントス	Juventus
ヨハネス	Johannes
ヨーロピアン	European
ランディング	landing
リジー	Lizzy
リマ	Lima
アクティビティー	activity
アーマー	armor
インサイド	inside
ウエッジ	wedge
カラット	carat
キューピー	kewpie
キル	kill
クリフ	cliff
クレイトン	Clayton
クローズド	closed
ケラー	Keller
コメディアン	comedian
コンペティション	competition
シュラフ	Schlaf
ジラフ	giraffe
スタンリー	Stanley
セクト	sect
セレロン	Celeron
チェスト	chest
ディール	deal
デイトレ	day trade
デューク	duke
ナイロビ	Nairobi
ナウマン	Naumann
ナン	nahn
バイザー	visor
バテレン	padre
ファブリック	fabric
フレーバー	flavor
ブラ	bra
ブラボー	bravo
ブルネッティ	Brunetti
プラシーボ	placebo
ヘリポート	heliport
ボルテール	Voltaire
ボローニャ	Bologna
ミルキー	milky
ローク	Rourke
ローテ	rotation
アムウェイ	Amway
アンプル	ampoule
アーキテクチャー	architecture
インディカ	indica
ウェリントン	Wellington
ウォッシュ	wash
カプチーノ	cappuccino
グリコーゲン	Glykogen
サビニー	Savigny
シンシア	Cynthia
スタートアップ	start-up
ストレッサー	stressor
スピルバーグ	Spielberg
スロバキア	Slovakia
センチュリー	century
テラ	terra
デュオ	duo
トラベラー	traveler
ピサ	Pisa
ブラームス	Brahms
ベロニカ	Veronica
ペレット	pellet
ホック	hook
マリアナ	Mariana
ミッチェル	Mitchell
レリーフ	relief
アナスタシア	Anastasia
アレッサンドロ	Alessandro
アンゴラ	Angola
アンネ	Anne
ウェルズ	Welles
エチル	ethyl
カルバン	Calvin
カンパ	kampaniya
サンローラン	Saint-Laurent
シューティング	shooting
スマッシュ	smash
スーパーマン	superman
ディスカス	discus
デリ	delicatessen
トゥデー	today
トライアングル	triangle
トランジット	transit
ノミネート	nominate
ノール	knoll
ハイランド	highland
バーグ	Vague
パプアニューギニア	Papua New Guinea
ビザンチン	Byzantine
フェルメール	Vermeer
ブックマーク	bookmark
ブライ	Bly
プラ	plastics
プラカード	placard
ボフィン	Boffin
ボレロ	bolero
ボンボン	bonbon
マイクロバス	microbus
マグネット	magnet
マンネリズム	mannerism
ラグランジュ	Lagrange
アームストロング	Armstrong
インス	Ince
インターンシップ	internship
エディプス	Oedipus
エルンスト	Ernst
カサブランカ	Casablanca
ガザ	Gaza
クラミジア	chlamydia
コルテス	Cortes
サプライヤー	supplier
サーボ	servo
ジョグ	jog
セイ	say
チョップ	chop
ナイトクラブ	nightclub
ナジ	Nagy
ハンニバル	Hannibal
バトラー	Butler
パンケーキ	pancake
パーライト	perlite
プロレタリアート	Proletariat
ヘッディング	heading
ホイットニー	Whitney
ポストモダン	postmodern
マクスウェル	maxwell
マゼラン	Magellan
マンデー	Monday
リスボン	Lisbon
ルーレット	roulette
ロナウド	Ronaldo
ローファー	Loafer
アッシリア	Assyria
アフロディテ	Aphrodite
アラファト	Arafat
アンダルシア	Andalucia
ウイ	oui
エデュケーション	education
エリクソン	Ericsson
オーガニゼーション	organization
カナリア	canaria
カルロ	Carlo
ガイザー	geyser
キルケゴール	Kierkegaard
クライミング	climbing
ゲラ	galley
ゲーリング	Goring
コリンズ	Collins
コンテント	content
シャットアウト	shut-out
ジョウロ	jorro
ストイック	stoic
ストラテジー	strategy
タルムード	Talmud
ダイナミクス	dynamics
ダンク	dunk
デュー	due
ハネムーン	honeymoon
バイリンガル	bilingual
パラサイト	parasite
パースペクティブ	perspective
ビストロ	bistro
ピンポイント	pinpoint
フットサル	futsal
フロイス	Frois
ブリティッシュ	British
ブリーフケース	briefcase
ボット	bot
ボージョレ	Beaujolais
ポストカード	postcard
メガホン	megaphone
ラポール	rapport
リカルド	Recardo
リクライニング	reclining
リボルバー	revolver
リポソーム	liposome
ルーニー	Loony
ロージー	rosy
アスペクト	aspect
アラカルト	a la carte
イモジェン	Imogen
インバーター	inverter
オセアニア	Oceania
オーサリング	authoring
カルピス	CALPIS
クリシュナ	Krsna
クーン	Kuhn
グロ	grotesque
グロー	glow
コミット	commit
コンプレッサー	compressor
コーデ	coordinate
サムネイル	thumbnail
シェアリング	sharing
ジェファーソン	Jefferson
ジフテリア	diphtheria
ジャッジ	judge
ジョアンナ	Joanna
タンニン	tannin
チフス	Typhus
ティータイム	teatime
トワイライト	twilight
ドラマー	drummer
ハイチ	Haiti
ハンドラー	handler
バギナ	vagina
パクストン	Paxton
フレスコ	fresco
プラム	plum
プリーストリー	Priestley
ベルリオーズ	Berlioz
ペガサス	Pegasus
メトロポリタン	metropolitan
リコー	RICOH
リベラリズム	liberalism
レタッチ	retouch
イッツ	it's
インスティチュート	institute
インダストリアル	industrial
オデュッセイア	Odysseia
カテリーナ	Catilina
キミ	Kimi
クメール	Khmer
クラック	crack
グルデン	gulden
グレアム	Graham
サラブレッド	thoroughbred
スザンナ	Susanna
スタッドレス	studless
ストーマ	stoma
セリーヌ	Celine
セレン	Selen
ターコイズ	turquoise
ティアラ	tiara
ディーン	Dean
ノスタルジック	nostalgic
パレート	Pareto
ピッキング	picking
ヘクトパスカル	hectopascal
ペリカン	pelican
マフィン	muffin
ミモザ	mimosa
モップ	mop
リュ	rue
アダムズ	Adams
アラビアン	Arabian
エスティマ	estima
エンパワーメント	empowerment
オルガニスト	organist
オーバーホール	overhaul
カリブー	caribou
グルーピング	grouping
コーナリング	cornering
サーベル	sabel
シリカ	silica
スコーン	scone
スハルト	Suharto
セージ	sage
ダッシュボード	dashboard
チグリス	Tigris
チャレンジャー	challenger
トラッド	trad
ナビゲーター	navigator
ネルー	Nehru
ハント	hunt
バッド	bad
バンガロー	bungalow
バーナー	burner
パジェロ	pajero
ヒズ	his
ビヘイビア	behavior
ファンクション	function
フォルスタッフ	Falstaff
フリッツ	Fritz
ブリテン	Britain
プライム	prime
プリーズ	please
ペンチ	pinchers
ボギー	bogey
モンク	Monk
レゴ	Lego
レニングラード	Leningrad
アナフィラキシー	Anaphylaxie
アーミー	army
インテリジェンス	intelligence
インディペンデント	independent
イースタン	eastern
カムバック	comeback
クリストフ	Kristof
クレーター	crater
クロニクル	chronicle
コンシューマー	consumer
シビック	civic
シャンゼリゼ	Champs-elysees
スパンコール	spangle
セルロース	cellulose
ダラ	Darra
テオ	Theo
テレパシー	telepathy
トスカーナ	Toscana
ドイル	Doyle
ドレッサー	dresser
バイオレンス	violence
パラボラ	parabola
ビター	bitter
フランシーヌ	Francine
ベッカー	Becker
ホーキンス	Hawkins
ボーダーレス	borderless
ボーリング	boring
マルティーニ	Martini
メカニック	mechanic
メンタリティー	mentality
モーラ	mora
ヤク	yak
リユース	reuse
ワッフル	waffle
アジ	agitation
アドルノ	Adorno
アナトリア	Anatolia
アンマン	Amman
イレギュラー	irregular
エルサルバドル	El Salvador
オーバーラップ	overlap
カシオペア	Cassiopeia
カタール	Qatar
カミュ	Camus
クリーチャー	Kreacher
ザン	than
シェパード	shepherd
ストラクチャー	structure
スペンサー	Spenser
ゼブラ	zebra
チープ	cheap
デューイ	Dewey
ナルシシズム	narcissism
ノルマンディー	Normandie
フォレスト	forest
マゾ	masochist
マルス	Mars
マーシャル	masar
モリソン	Morrison
ラード	lard
リッチー	Richie
レイテ	Leyte
レスリー	Leslie
レッセ	laisser
レニー	Renny
ロマノフ	Romanov
アイゼンハワー	Eisenhower
アコード	accord
インターバル	interval
エレノア	Eleanor
オートマトン	automaton
カーネル	kernel
キオスク	kiosk
ギブソン	Gibson
クルージング	cruising
グリーンランド	Greenland
コミッショナー	commissioner
コンディショナー	conditioner
コーデュロイ	corduroy
ジグ	jig
ジュー	jew
ジンクス	jinx
スタンレー	Stanley
タッパー	Tupperware
デフ	deaf
ネスト	nest
バークレー	Berkeley
パッシブ	passive
フューチャー	future
ブライト	bright
ブレーキング	braking
プロテクター	protector
マラヤ	Malaya
マルサス	Malthus
モンテーニュ	Montaigne
リテール	retail
リバース	reverse
ルピー	rupee
ルーブル	rouble
レアル	real
レイフ	Ralph
レシーバー	receiver
レット	let
レバレッジ	leverage
レフェリー	referee
ロバーツ	Roberts
アーカイブ	archive
イデア	idea
ウォッチャー	watcher
エッチング	etching
エフェソス	Ephesos
オラクル	oracle
オルターナティブ	alternative
カンニング	cunning
ガンジス	Ganges
キャパシティー	capacity
グスタフ	Gustav
グレープ	grape
コング	Kong
サンチアゴ	Santiago
シリー	silly
ジュレ	gelee
ジョシュア	Joshua
ストラット	strut
ターニング	turning
ティア	tier
テンプル	temple
ディベート	debate
デュポン	Du Pont
デラウェア	Delaware
ドジャー	dodger
ドーピング	doping
ハスキー	husky
バックパック	backpack
ビュフォン	Buffon
フレミング	Fleming
ヘテロ	hetero
ベンゾジアゼピン	benzodiazepine
ペインティング	painting
ボルネオ	Borneo
マスカット	muscat
ミレニアム	millennium
モンスーン	monsoon
ライチー	litchi
ランボー	Rimbaud
ワイキキ	Waikiki
アウグスティヌス	Augustinus
アドミニストレーター	administrator
アレクサンドロス	Alexandros
エスプレッソ	espresso
エンドレス	endless
オルタネーター	alternator
オートメーション	automation
ガリレイ	Galilei
ガロン	gallon
コダック	Kodak
コミッティー	committee
シガー	cigar
シルキー	silky
ジュラ	Jura
ジンバブエ	Zimbabwe
スカンジナビア	Scandinavia
スレ	thread
ダーシー	Darcey
デンバー	Denver
トレーディング	trading
ドジスン	Dodgeson
ドミノ	domino
ナチズム	Nazism
ネグリジェ	neglige
ハイエナ	hyena
バイブレーター	vibrator
ヒルベルト	Hilbert
ビーグル	beagle
フルシチョフ	Khrushchyov
フルーティー	fruity
ブリーチ	bleach
ブルース	blues
プランテーション	plantation
プロポ	proportional
ヘアピン	hairpin
ペンス	pence
ホワイトボード	whiteboard
マウスピース	mouthpiece
ミステリアス	mysterious
モジュラー	modular
モッツァレラ	mozzarella
リチャードソン	Richardson
リーマン	salaryman
アプリコット	apricot
アルタイ	Altai
インテリジェント	intelligent
インフォーマル	informal
ウォーム	warm
エロチシズム	eroticism
オスロ	Oslo
オートマ	automatic
オーム	ohm
カルタゴ	Carthago
ガトー	gateau
ガル	Gall
キューピッド	Cupid
キルティング	quilting
クロノス	Khronos
グリ	gris
コンパイラー	compiler
サイレント	silent
シエスタ	siesta
シトロエン	Citroen
シュルツ	Schulz
シング	thing
スパーク	spark
スポイト	spuit
スライディング	sliding
スリング	sling
ターバン	turban
チアー	cheer
チャーチ	church
テロメア	telomere
ニュートリノ	neutrino
バックル	buckle
バースト	burst
ビリルビン	bilirubin
フリンジ	fringe
フール	four
プリティー	pretty
プリマ	prima
ペンタックス	PENTAX
ポタージュ	potage
マルガリータ	Margarita
ラシャ	raxa
アクター	actor
アメラジアン	Amerasian
アレクセイ	Aleksei
エイラ	Ayla
エイリアス	alias
カルテット	quartetto
クランベリー	cranberry
グランパス	grampus
サンセット	sunset
スパークリング	sparkling
スーダン	Sudan
ダミアーノ	Damiano
チェーホフ	Chekhov
デキムス	Decimus
デマンド	demand
トロン	thoron
ドンナ	donna
ニコルソン	Nicholson
ノバ	nova
ハング	hang
バルチュス	Balthus
バルナバ	Barnabas
バーゼル	Basel
パッション	passion
パラオ	Belau
ビューアー	viewer
フェザー	feather
フェーブル	Febvre
フォルクスワーゲン	Volkswagen
フラミンゴ	flamingo
ブルク	Burg
プロムナード	promenade
ホンジュラス	Honduras
マクルーハン	McLuhan
マルグリット	Marguerite
マーマレード	marmalade
ミノルタ	Minolta
メリヤス	medias
アダージョ	adagio
アドバンテージ	advantage
アムンセン	Amundsen
アンモニウム	ammonium
エキスポ	expo
オペレーティング	operating
ガーゴイル	gargoyle
ギャルソン	garcon
クラム	clam
グル	guru
コンパウンド	compound
ゴス	Gothic
サムソン	Samson
シル	sill
シンセサイザー	synthesizer
シンチグラフィー	scintigraphy
ジェフリー	Geoffrey
ジグソー	jigsaw
スイートピー	sweet pea
スラッシュ	slash
タトゥー	tattoo
ヌーベル	nouvelle
ハリアー	harrier
ヒッター	hitter
フィラメント	filament
フェル	Fell
フラストレーション	frustration
フリーダム	freedom
プリンストン	Princeton
プルーン	prune
ホチキス	Hotchkiss
ポエム	poem
メロドラマ	melodrama
ランスロット	Lancelot
ラーン	learn
リーフレット	leaflet
アイザック	Isaac
アカデミズム	academism
アモン	Ammon
アントラー	antler
イリノイ	Illinois
インドア	indoor
エイミー	Amy
エレガンス	elegance
エンスト	engine stop
オキシダント	oxidant
オパール	opal
カウ	cow
カウンティー	county
カスケード	cascade
カトリーヌ	Catherine
ガレ	Galle
ガーシュイン	Gershwin
グルーブ	groove
ケトン	ketone
サイプレス	cypress
サモア	Samoa
シンプソン	Simpson
ジョーカー	joker
スクラッチ	scratch
スティッチ	Stitch
ステレオタイプ	stereotype
ダレス	Dulles
テレワーク	telework
トロンボーン	trombone
ドガ	Degas
ドグマ	dogma
ドリア	doria
バギー	buggy
バルチック	Baltic
ヒルトン	Hilton
ベイユ	Weil
ホメロス	Homeros
ホルスター	holster
ボルシェビキ	Bol'sheviki
ポリウレタン	polyurethane
ポーツマス	Portsmouth
ミリアム	Miriam
メーヤー	Mayer
ライプニッツ	Leibniz
ラスキン	Ruskin
ラモス	Ramos
リリー	lily
ルイジアナ	Louisiana
レギュレーション	regulation
レトリーバー	retriever
アイリッシュ	Irish
アシドーシス	acidosis
アドマイヤ	admire
アラインメント	alignment
ウィンブルドン	Wimbledon
エマルジョン	emulsion
エンパイア	empire
オレゴン	Oregon
カブレラ	Cabrera
ガレー	galley
ギムナジウム	gymnasium
ギャラクシー	galaxy
グリーティング	greeting
ケベック	Quebec
コンシーラー	concealer
ゴールキーパー	goalkeeper
シシャモ	susam
シャッフル	shuffle
シュールレアリスム	surrealisme
シラノ	Cyrano
ジェマ	Gemma
ジェレド	Jered
スパート	spurt
ゾロ	Zorro
タピオカ	tapioca
タブレット	tablet
タンバリン	tambourine
ダイアリー	diary
ダブリン	Dublin
トレッド	tread
ハバナ	Havana
ハンディー	handy
ハーベー	Harvey
バイナリー	binary
バリトン	baritone
パイル	pile
ヒンジ	hinge
ピール	peel
フスト	Fust
フラボノイド	flavonoid
フリーランス	freelance
ポステッド	posted
マリオン	mullion
モリアーティ	moriarty
リーン	lean
アコーディオン	accordion
アルテミス	Artemis
アンアン	an an
アントワネット	Antoinette
イクサ	IXA
ウイニング	winning
エドウィン	Edwin
カイル	Kyle
ガリバー	Gulliver
キーリー	Keeley
クアトロ	quatro
クオーク	quark
クローニング	cloning
ゲマインデ	Gemeinde
コマース	commerce
ゴダール	Godard
シェード	shade
シミュレーター	simulator
スロベニア	Slovenia
タロット	tarot
チョラ	Chora
ディルタイ	Dilthey
トリム	trim
トレーダー	trader
ドビュッシー	Debussy
ドント	don't
パドル	paddle
ピッツバーグ	Pittsburgh
ファンシー	fancy
フィーバー	fever
フェイシャル	facial
ペレストロイカ	perestroika
ポンティ	Ponti
マウイ	Maui
マートン	Merton
ムスタング	mustang
メンデルスゾーン	Mendelssohn
メンフィス	Memphis
モルジブ	Maldives
ユニコーン	unicorn
レストア	restore
ロザリー	Rosalie
アカペラ	a cappella
アセア	Asea
アップリケ	applique
アトラス	atlas
イメージング	imaging
オタワ	Ottawa
オムニバス	omnibus
オンエアー	on-air
オーソリティー	authority
クリエート	create
クロージング	closing
グロピウス	Gropius
ケースワーク	casework
コースト	coast
サラエボ	Sarajevo
シクラメン	cyclamen
ジッド	Gide
ジーン	gene
スワロフスキー	Swarovski
ソナー	sonar
ソリスト	soliste
タンデム	tandem
ティファニー	Tiffany
ティーポット	teapot
トニック	tonic
トラム	tram
トリウム	Thorium
ナダール	Nadar
ハッキング	hacking
ハドソン	Hudson
パレルモ	Palermo
パース	purse
パーマー	Palmer
ファージ	phage
フィアンセ	fiance
フォークリフト	forklift
フランチェスカ	Franziska
フレーミング	framing
ブルボン	Bourbon
ブルーマー	bloomer
ベレニス	Berenice
ベロア	velours
ペトロ	petro
ボイルド	boiled
マグナム	magnum
マテ	mate
ミッテラン	Mitterrand
ミーン	mean
メルロー	Merleau
ヨーク	yoke
ランダー	Lander
アベレージ	average
アルジェ	Alger
アロンソ	Alonso
インベストメント	investment
エッセイスト	essayist
エンロン	Enron
オーガスタス	Augustus
カイト	kite
カルデラ	caldera
コルビュジエ	Corbusier
コンサルテーション	consultation
コンチェルト	concerto
サイード	Said
シンボリック	symbolic
ジョイス	Joyce
スタントン	Stanton
ストレッチャー	stretcher
スネア	snare
スレーブ	slave
タミル	Tamil
デフォルメ	deformer
ドリップ	drip
バックボーン	backbone
ヒューストン	Huston
フアン	Juan
フビライ	Qubilai
ブレンダン	Brendan
ブロイラー	broiler
ミズ	Ms
メカニカル	mechanical
メゾン	maison
ヨークシャー	Yorkshire
ラジ	Raji
ラリサ	Larisa
リプレー	replay
レジーム	regime
アウグスト	Augusto
アネモネ	anemone
アルギニン	arginine
アルス	ars
アーク	ark
イマジネーション	imagination
インスト	instrumental
ウィノナ	Wynona
ウクレレ	ukulele
エッジング	edging
エラスムス	Erasmus
オフェンス	offense
カバラ	cabala
カルティエ	quartier
カルパッチョ	Carpaccio
カーデ	cardigan
キッカー	kicker
クリーク	creek
コペルニクス	Copernicus
コル	col
ゴーイング	going
シメオン	Simeon
シーサイド	seaside
スタッド	stud
スパッツ	spats
スレンダー	slender
セラミックス	ceramics
セルジオ	Sergio
デスティニー	destiny
ドクトリン	doctrine
ドレスデン	Dresden
ヌー	gnu
ネバダ	Nevada
ハマー	Hammer
ハンモック	hammock
バンドル	bundle
パブロ	Pablo
パルファン	parfum
ビショップ	bishop
ビノ	vino
ピノ	pinot
ファッショナブル	fashionable
ファーマー	farmer
フレグランス	fragrance
ブルネイ	Brunei
プロテアーゼ	protease
ホーネット	hornet
マリーゴールド	marigold
ムニエル	meuniere
ラゲージ	luggage
ルノワール	Renoir
ルーティング	routing
ルームメート	roommate
レジスター	register
ロゴス	logos
ロディー	Roddy
ローラン	Laurent
アイライナー	eyeliner
アグリ	agriculture
アセチルコリン	acetylcholine
アラバマ	Alabama
アルダ	Alda
アルブミン	albumin
アンゼリカ	angelica
アーリア	Arya
インジケーター	indicator
インジゴ	indigo
エキセントリック	eccentric
カシミール	Kashmir
カーソン	Carson
キャロット	calotte
クスクス	Cuscus
コラムニスト	columnist
コリー	colly
コンツェルン	Konzern
サピエンス	sapiens
シガレット	cigarette
シーマ	cima
ジェラート	gelato
ジャーマン	German
スイム	swim
スノボー	snowboard
セレッソ	Cerezo
チュニック	tunic
ティック	tick
トラッキング	tracking
ナンプラー	namplaa
ハイドリヒ	Heydrich
ハグ	hug
ハノーバー	Hannover
バウムクーヘン	Baumkuchen
バラスト	ballast
ヒストグラム	histogram
ヒドロキシ	hydroxy
ビザンツ	Byzanz
ピアソラ	Piazzolla
ファンケル	FANCL
フォルテ	forte
ベイリー	Bayley
モルモット	marmot
ラウドネス	loudness
ラグジュアリー	luxury
ラディッシュ	radish
リボーン	reborn
ロキ	loci
ロッキング	rocking
ロブスター	lobster
ロータス	lotus
アウトサイダー	outsider
アポイント	appointment
アルゴン	argon
アンダーグラウンド	underground
アーカンソー	Arkansas
ウッディー	Woody
カタル	catarre
カメオ	cameo
カンタータ	cantata
キャリパー	caliper
クラッシャー	crusher
グツェリエフ	Gutseriyev
コッホ	Koch
コネチカット	Connecticut
コードレス	cordless
コーラル	coral
サラミ	salami
ジャッキ	jack
ジョーイ	Joey
ストレージ	storage
ズー	zoo
セザール	Cesar
チェンマイ	Chiengmai
ディアス	Dias
デージー	daisy
ニンフ	nymph
ネグレクト	neglect
ネフローゼ	Nephrose
ノベル	novel
バレリー	Valery
バーウェル	Burwell
バーミンガム	Birmingham
パイピング	piping
パシャ	pasha
パフィオ	Paphiopedilum
ヒロ	Hilo
ビフォー	before
ビューロー	bureau
フレイア	Freia
ブルックス	Brooks
ヘレニズム	Hellenism
ヘーブン	haven
ベネット	Bennett
ホルマリン	Formalin
ボイジャー	voyager
マオリ	Maori
マリアーノ	Mariano
マーメード	mermaid
ミズーリ	Missouri
メリーランド	Maryland
モデリング	modeling
ラルク	L'arc
リハ	rehearsal
ルカイヤ	Ruqaiyyah
レセプト	Rezept
ワセリン	Vaseline
アウトロー	outlaw
アズ	as
アパルトヘイト	apartheid
アフタヌーン	afternoon
アービング	Irving
イリュージョン	illusion
オッフェンバック	Offenbach
オールマイティー	almighty
カマー	comer
キネマ	kinema
コンストラクター	constructor
コンフリクト	conflict
コートニー	Courtney
シャーク	shark
ジャッカル	jackal
ジュビロ	Jubilo
ジュラルミン	duralumin
スキューバ	scuba
タント	Thant
タンブラー	tumbler
タンポン	Tampon
ダス	das
テラコッタ	terracotta
ハイエク	Hayek
バイタリティー	vitality
バイタル	vital
バーンアウト	burnout
ビズ	biz
ファラ	Farrah
フェアリー	fairy
フェス	festival
フォグ	fog
ブレーメン	Bremen
ブロード	broad
ベアー	bear
ベラルーシ	Belarus
ボッシュ	Bosch
マシュマロ	marshmallow
ミネソタ	Minnesota
モレッティ	Moretti
ユーリ	Yurii
ルワンダ	Rwanda
ロンド	rondo
ワイナリー	winery
ワッペン	Wappen
アイオワ	Iowa
アブ	Abu
アンソロジー	anthology
アンドロゲン	androgen
インセスト	incest
ウィンザー	Windsor
ウォーマー	warmer
エカテリーナ	Ekaterina
エシャロット	echalote
カピタン	capitao
カメレオン	chameleon
コミュニスト	communist
サルサ	salsa
ジョー	jaw
スプリンター	sprinter
セック	sec
ソレイユ	soleil
タンガニーカ	Tanganyika
タングステン	tungsten
ダイアフラム	diaphragm
ツベルクリン	Tuberkulin
トランスミッション	transmission
ノンストップ	nonstop
ノーブル	noble
ピサロ	Pizarro
フィッシング	phishing
プルーフ	proof
プロシア	Prussia
ヘルムート	Helmut
ベオグラード	Beograd
ベルン	Bern
ホメオスタシス	homeostasis
ボム	bomb
ボルガ	Volga
ポセイドン	Poseidon
マホガニー	mahogany
モー	mho
ユビキタス	ubiquitous
ラシーヌ	Racine
リミックス	remix
リーバイス	Levi's
ルーペ	Lupe
アナロジー	analogy
アビリティー	ability
アフロ	Afro
インターン	intern
ウェストミンスター	Westminster
ウラボン	ullambana
エキサイティング	exciting
エスケープ	escape
オリゲネス	Origenes
オールコック	Alcock
カムパネルラ	Campanella
クロエ	Chloe
グラナダ	Granada
ケルビン	Kelvin
コックス	cox
コムサ	comme ca
コーンビーフ	corned beef
サンダーバード	thunderbird
シニフィアン	signifiant
ジブラルタル	Gibraltar
ジュディス	Judith
スイッチング	switching
ステム	stem
セッター	setter
ソングライター	songwriter
ダーティー	dirty
トーテム	totem
ナツメグ	nutmeg
ニヒリズム	nihilism
ニールス	Niels
ハイフン	hyphen
ハングリー	hungry
パケ	package
ビオレッタ	Violetta
ピーリング	peeling
ファイリング	filing
フェニキア	Phoenicia
フォックス	fox
プトレマイオス	Ptolemaios
ベトミン	Viet Minh
ペリエ	Perrier
ポラロイド	Polaroid
マッシュ	mash
マンドリン	mandolin
マーストリヒト	Maastricht
ミルフィーユ	millefeuille
ミレー	Millet
ユーフラテス	Euphrates
ラドクリフ	Radcliffe
リレーション	relation
レイス	Reis
レシオ	ratio
アルル	Arles
イシュマエル	Ishmael
インタビュアー	interviewer
オナー	honor
オンタリオ	Ontario
オーボエ	oboe
カウチ	couch
カザン	Kazan
カルノー	Carnot
ギャザー	gather
クレオール	creole
コーク	coke
シビリアン	civilian
シラー	Schiller
ジャイロ	gyro
セブ	Cebu
セルゲイ	Sergey
テフロン	Teflon
ディキシー	Dixie
トポス	topos
ドッジボール	dodgeball
ニード	need
パネリスト	panelist
パンサー	panther
ヒッチコック	Hitchcock
ファサード	facade
ファシリテーター	facilitator
フィヒテ	Fichte
ブリッツ	blitz
ブルドッグ	bulldog
プジョー	Peugeot
プット	put
プロブレム	problem
ポカリ	Pocari
ポシェット	pochette
マッカートニー	McCartney
マッタ	Matta
ミクロネシア	Micronesia
メランコリー	melancholy
モラ	mola
モロトフ	Morotob
モンゴロイド	Mongoloid
ラッカー	lacquer
リストラクチュアリング	restructuring
ルートビヒ	Ludwig
ロビイスト	lobbyist
ロールス	Rolls
アグレッシブ	aggressive
アネット	Anette
アルカン	alkane
アングラ	underground
イド	id
イングリッド	Ingrid
エクステリア	exterior
エバンゲリオン	evangelion
オレ	Ole
オンス	ounce
カトレア	cattleya
カラン	kraan
カルチュラル	cultural
カーラー	curler
コミュニケ	communique
コモンズ	commons
コーカサス	Caucasus
ゴビ	Gobi
サブタイトル	subtitle
サポニン	saponin
シャットダウン	shutdown
シュレッダー	shredder
シンジケート	syndicate
ジャーニー	journey
ステークホルダー	stakeholder
センタリング	centring
タートルネック	turtleneck
ダッカ	Dacca
チャド	Chad
チュール	tulle
デット	debt
ノルマン	Norman
バンパイア	vampire
パーミル	permil
ファンタ	Fanta
ファーガソン	Ferguson
ブーメラン	boomerang
プラスミド	plasmid
ホアキン	Joaquin
ボーア	Boer
マイクロフィルム	microfilm
マーリク	Malik
ミーア	mia
ライコネン	Raikkonen
リバティー	liberty
リミッター	limiter
アミューズ	amuse
アーネスト	Ernest
インタレスト	interest
インターラクティブ	interactive
インペリアル	imperial
エゼキエル	Ezekiel
エル	el
カニューレ	Kanule
カムチャツカ	Kamchatka
キノ	kino
キュービズム	cubism
クライ	cry
クライム	crime
クラリス	Claris
クレール	Clair
グラハム	Graham
ケッペン	Koppen
コルベット	corvette
コンタックス	Contax
ゴブリン	goblin
サイロ	silo
サガ	saga
シエラ	sierra
ショーペンハウアー	Schopenhauer
ジェネレーション	generation
ジュエル	jewel
スターリング	sterling
セドリック	Cedric
タジキスタン	Tadzhikistan
ターザン	Tarzan
デルフォイ	Delphoi
ナタポン	Natapong
ニジェール	Niger
ニュークリア	nuclear
ノエル	Noel
バイアグラ	Viagra
バベル	Babel
バーネット	Barnett
パーソンズ	Parsons
フォーチュン	fortune
ブルーム	bloom
ヘブン	heaven
ベジタブル	vegetable
マクシミリアン	Maximilian
ミンク	mink
ライヒ	Reich
ラスプーチン	Rasputin
リッジ	ridge
リテーリング	retailing
レクイエム	requiem
ロイズ	Lloyd's
ローレル	laurel
アセチル	acetyl
アデレード	Adelaide
アニバーサリー	anniversary
アムール	Amur
インサート	insert
ウエハー	wafer
エリツィン	El'tsin
オデッサ	Odessa
オリー	Ory
オレガノ	oregano
オールデン	Alden
カプラー	coupler
カレン	Karen
ガリバルディ	Garibaldi
キャメル	camel
キルギス	Kirghiz
グラバー	Glover
グリニッジ	Greenwich
コルドバ	Cordova
コンピューティング	computing
コンボイ	convoy
サスキア	Saskia
サブルーチン	subroutine
シザー	scissor
シナジー	synergy
シャップ	Chappe
シュタイナー	Steiner
スクリャービン	Skryabin
スクリーム	scream
ストラビンスキー	Stravinskii
スパナ	spanner
セク	sector
ソフィア	sophia
タキオン	tachyon
タルタル	tartar
ダミアン	Damien
テストステロン	testosterone
テレックス	telex
テーラード	tailored
デッカ	Decca
トゥルース	truth
トルマリン	tourmaline
ドラッカー	Drucker
ドレープ	drape
ナッシング	nothing
ヌーレディン	Nourredine
ノルアドレナリン	noradrenalin
ハースト	Hearst
バリエ	variee
バルサミコ	balsamico
バルトーク	Bartok
ヒース	heath
ファンク	funk
ファーザー	father
フェデリコ	Federico
フェンシング	fencing
プレリュード	prelude
ベイト	bait
ペンタゴン	pentagon
ホメオパチー	Homoopathie
ホロコースト	holocaust
ポリプロピレン	polypropylene
モディリアーニ	Modigliani
モトクロス	motocross
ライラック	lilac
ラッパー	rapper
ラトビア	Latvia
ランコム	Lancome
リガンド	ligand
リヤカー	rearcar
ロマネスク	Romanesque
アゲイン	again
アスペルガー	Asperger
アセトン	acetone
アバント	avant
アルマ	alma
アルマン	Armand
アーミテージ	Armitage
エスタブリッシュメント	establishment
エスティ	Estee
エリ	Eli
オクラホマ	Oklahoma
オーパ	opa
オーフェン	Orphen
ガリア	Gallia
クラウチ	Crouch
グレコ	Greco
コリアンダー	coriander
ゴーレム	golem
ザクセン	Sachsen
シニカル	cynical
ジェド	Jed
スキンヘッド	skinhead
ゼネスト	general strike
タイピスト	typist
チアノーゼ	Zyanose
チケ	ticket
テキスタイル	textile
デタント	detente
トルファン	Turfan
パティスリー	patisserie
パブロフ	Pavlov
ピノキオ	Pinocchio
フェブラリー	February
フォーエバー	forever
フォーレ	Faure
フライアー	flier
フレックスタイム	flextime
ブラケット	bracket
ブリーフ	brief
ブロッカー	blocker
プリセット	preset
プロゲステロン	progesterone
マキシ	maxi
マキシマム	maximum
マーリン	Merlyn
ミニッツ	minute
ムンク	Munch
メトロノーム	Metronom
ユージン	Eugene
ラマン	Raman
リカー	liquor
リュー	Liu
リーガ	RIHGA
ルコック	Lecocq
ルピア	rupiah
ルポルタージュ	reportage
ロマンチスム	romanticism
アタッカー	attacker
アペックス	apex
アングロ	Anglo
エアロパーツ	aero-parts
オイディプス	Oedipus
オランウータン	orangutan
オークランド	Auckland
オージー	Aussie
ガードナー	Gardner
ガーベラ	gerbera
キャナル	canal
キーマン	keyman
クライマー	climber
クロフト	Croft
ケイシー	Cayce
コンポート	compote
サイボーグ	cyborg
サブネット	subnet
シラブル	syllable
スクレーパー	scraper
スプリンクラー	sprinkler
スペクタクル	spectacle
セリシン	sericin
セルロイド	celluloid
ディフェンダー	defender
デカール	decal
トナー	toner
トパーズ	topaz
ドロップアウト	drop-out
パエーリャ	paella
ファラオ	Pharaoh
フィルタリング	filtering
フィーチャー	feature
フェロー	fellow
フルトベングラー	Furtwangler
マドモアゼル	mademoiselle
ムーブ	move
モラール	morale
ヤルタ	Yalta
ユーミン	Yuming
リディア	Lydia
リバイアサン	Leviathan
リペアー	repair
レギュレーター	regulator
レバション	Reverchon
ワークステーション	work station
アゼルバイジャン	Azerbaidzhan
アミ	ami
アワード	award
イシス	Isis
イントラ	intra-
ウィンストン	Winston
ウォーターフロント	waterfront
ウガンダ	Uganda
エクソン	Exxon
エゴグラム	egogram
エリコ	Jericho
エレクトーン	Electone
キリコ	Chirico
ギルダー	guilder
クルサード	Coulthard
クルス	cruz
クロパトキン	Kuropatkin
クンニ	cunnilingus
ゲシュタルト	Gestalt
ゲルマニウム	Germanium
コンコルド	concorde
シャント	shunt
シーレ	Schiele
スカルプ	scalp
スナイパー	sniper
スペ	special
ダンシング	dancing
ダンロップ	Dunlop
トリクロロエチレン	trichloroethylene
ナレーター	narrator
ニッパー	nipper
ニトロ	nitro
バッカス	Bacchus
パピー	puppy
パルメザン	Parmesan
フィラリア	filaria
フェリス	Ferris
フォスター	Foster
フランクス	Franks
フレット	fret
ブリーフィング	briefing
ブータン	Bhutan
ヘゲモニー	Hegemonie
ヘラルド	herald
ベニン	Benin
ペディメント	pediment
ペーソス	pathos
ホエー	whey
ホランド	Holland
マスターベーション	masturbation
マンボ	mambo
マードック	Murdoch
マーロー	Marlowe
ラジウム	radium
ラナルド	Ranald
ラバウル	Rabaul
リノール	linole
ローリエ	laurier
ワンス	once
アイボリー	ivory
アビニョン	Avignon
アフターケア	aftercare
アミーゴ	amigo
アルデヒド	aldehyde
アルペン	Alpen
アンクル	uncle
アントニウス	Antonius
カウラ	Cowra
カウンシル	council
ガーディアン	guardian
ガーリー	girlie
キャブレター	carburetor
グリー	glee
コンピタンス	competence
コーディ	Cody Codey
サブプライム	subprime
シンパ	sympathizer
スカラ	scala
スポークスマン	spokesman
ゼッケン	Decke
ソレ	sole
デコルテ	decorte
トピア	Topia
トランポリン	trampoline
ドップラー	Doppler
ドリアン	durian
ドンキホーテ	Don Quijote
ナザレ	Nazareth
ニミッツ	Nimitz
ハーレム	Harlem
バプテスト	baptist
パブリシティー	publicity
パルパティーン	Palpatine
ビッド	bid
ピアジェ	Piaget
ファイナライズ	finalize
フェネル	fennel
フェレット	ferret
フエ	Hue
フッド	Hood
フランチャイジー	franchisee
ブラッシュ	brush
ブロードキャスト	broadcast
プロパー	proper
プロフ	profile
ペクチン	pectin
ホイッスル	whistle
ボサノバ	bossa nova
ボーイッシュ	boyish
マグナ	Magna
マジカル	magical
マドレーヌ	madeleine
ミッジ	Midge
メドゥーサ	Medusa
モロゾフ	Morozov
ユーカラ	Yukar
ラカン	Lacan
ラスキ	Laski
ランチョン	luncheon
リグ	rig
リフ	riff
リレーションシップ	relationship
アイシング	icing
アトリウム	atrium
アニュアル	annual
アプライド	applied
アミューズメント	amusement
イースター	Easter
エアーバス	airbus
エスプリ	esprit
エリクシール	elixir
エレクトロニック	electronic
オフィサー	officer
キンバリー	Kimberley
グラマラス	glamourous
ケラハー	Kelleher
ケント	Kent
ゲクラン	Guesclin
コニャック	cognac
コンクリ	concrete
コンスタン	Constant
サイコ	psycho
スタグフレーション	stagflation
スタビライザー	stabilizer
スプリット	split
スペーサー	spacer
セイバー	saber
セックスレス	sexless
トリシア	Tricia
ドイチェ	Deutsche
ナゲット	nugget
ナーシング	nursing
ハミング	humming
ハーマン	Hamann
パンジャブ	Panjab
ビデオテックス	videotex
ピケ	picket
ファクト	fact
ファンファーレ	fanfare
フランジ	flange
ブロンセ	Bronce
プリ	prix
ボキャブラリー	vocabulary
マルタン	Martin
マンディ	Mandy
ミューズ	Muse
ムール	moule
メヌエット	menuetto
メラミン	melamine
モザンビーク	Mozambique
モロ	Morro
モンタナ	Montana
ラボラトリー	laboratory
レジン	resin
レンナー	Renner
ロマンチシスト	romanticist
アウトサイド	outside
アカデミア	academia
アセトアルデヒド	acetaldehyde
アブソーバー	absorber
アンドロイド	android
イニシエーション	initiation
ウルムチ	Urumchi
オスター	Oster
カテキン	catechin
カールスルーエ	Karlsruhe
ガラパゴス	Galapagos
キャタピラー	caterpillar
キャニオン	canyon
クライシス	crisis
クラプトン	Clapton
クランチ	crunch
クレメンス	Clemens
ケアンズ	Cairns
コロサイ	Kolossai
コーム	comb
サルデーニャ	Sardegna
サンドペーパー	sandpaper
ザンビア	Zambia
ジギタリス	digitalis
ジャップ	Jap
スクーリング	schooling
ストラスブール	Strasbourg
ズック	doek
セシウム	cesium
タンポナーデ	tanponade
ターンテーブル	turntable
チャオ	ciao
ディケイ	decay
デニーロ	De Niro
デリラ	Delilah
トゥース	tooth
トマ	Thomas
ドローイング	drawing
バジェット	budget
バチスタ	Batisuta
プリマス	Plymouth
プロテクト	protect
プロテスタンティズム	Protestantism
ベガルタ	Vegalta
ベネッセ	Benesse
ホスピタリティー	hospitality
マサラ	masala
マスキング	masking
メルカトル	Mercator
ラガー	lager
ランカ	Lanka
リアス	rias
ロディック	Roddick
アセス	assess
アメジスト	amethyst
アメフト	American football
アンカレジ	Anchorage
アンギオテンシン	angiotensin
ウィルコム	Willcom
エビデンス	evidence
エボ	evolution
エンコーダー	encoder
オボ	ovoid
オリビエ	Olivier
オーギュスト	Auguste
オード	ode
カタパルト	catapult
ガスト	gusto
キッシュ	quiche
キャンバー	camber
キャンベラ	Canberra
キュービック	cubic
クラリン	clarin
クロロホルム	Chloroform
グレップ	grep
コレクティブ	collective
サポ	support
サムシング	something
ザイル	Seil
ザイール	Zaire
シオニズム	Zionism
ジェントルマン	gentleman
スカイプ	Skype
スコラ	schola
スペアリブ	spareribs
ソルボンヌ	Sorbonne
ソーマ	soma
テクノポリス	technopolis
ディスレクシア	Dyslexia
ディップ	dip
トライアスロン	triathlon
ドルフィン	dolphin
ニードル	needle
ノルム	norme
バルガス	Vargas
バンジー	bungee
バーム	balm
パッキング	packing
パックス	Pax
パーカッション	percussion
ファック	fuck
ファッショ	fascio
フェノロサ	Fenollosa
フランネル	flannel
ブゾーニ	Busoni
プリニウス	Plinius
プレーイング	playing
ベケット	Becket
ベンサム	Bentham
ポリティック	politic
マイルス	Miles
マオ	Mao
マッカーシー	McCarthy
マース	Mars
モノラル	monaural
ラサ	Lhasa
ラザルス	Lazarus
ランジェリー	lingerie
リアン	Lien
レスター	Lester
レーヨン	rayon
ロザリオ	rosario
ロベスピエール	Robespierre
ワルター	Walter
アプリオリ	a priori
アマリリス	amaryllis
アラジン	Aladdin
アルテア	Altea
アントシアニン	anthocyanin
イカロス	Ikaros
イゾリーナ	Isolina
インスペクター	inspector
インドラ	Indra
ウィスコンシン	Wisconsin
ウィッシュ	wish
エクストリーム	extreme
エクセレント	excellent
エメレンツィア	Emelenzia
エンタ	entertainment
エンバイロメント	environment
オリエンテーリング	orienteering
オースティン	Austen
カシュー	cashew
キャンパー	camper
クエーカー	Quaker
クランプ	clamp
グラマー	grammar
グランマ	grandma
グレンダ	Glenda
コピーライター	copywriter
コルチゾール	cortisol
コンソーシアム	consortium
コンテ	continuity
コンドミニアム	condominium
サファビー	Safavi
サマリー	summary
サンドラ	Sandra
サーモスタット	thermostat
サール	Searle
ザール	Zaal
シリウス	Sirius
ジャケ	jacket
ジーグ	gigue
スタント	stunt
ステルス	stealth
ターメリック	turmeric
チューリング	Turing
デストロン	Destron
デポジット	deposit
トムソン	Thomson
トランシーバー	transceiver
ドウ	Doe
ドボルザーク	Dvorak
ドリトル	Dolittle
ノッキング	knocking
ハイカー	hiker
ハッブル	Hubble
バイエル	Bayer
バキューム	vacuum
バスラ	Basra
バタビア	Batavia
バニー	bunny
フォトクロミック	photochromic
フォリフォリ	Folli Follie
フランチャイザー	franchiser
プルースト	Proust
プロテクション	protection
ヘラ	Hera
ペペロンチーノ	peperoncino
ボーカリスト	vocalist
ボーダーライン	borderline
ポメラニアン	Pomeranian
マトン	mutton
マリオット	Marriott
マルロー	Malraux
メゾ	mezzo
モーゲージ	mortgage
リバーシブル	reversible
レク	recreation
ロジャーズ	Rodgers
アイヒマン	Eichmann
アナリシス	analysis
アーチェリー	archery
イグニッション	ignition
イソップ	Aesop
ウェルギリウス	Vergilius
エピ	epi
エマーソン	Emerson
オルフェウス	Orpheus
オーバル	oval
オーライ	all right
カナディアン	Canadian
ガウス	Gauss
クミン	cumin
クリミア	Crimea
クレバス	crevasse
クレー	clay
グミ	gummi
コフ	cough
コミューター	commuter
コンコース	concourse
コンラッド	Conrad
シェアード	shared
シモーヌ	Simone
ジェンナー	Jenner
ジオシティーズ	Geocities
ジャクリーン	Jacqueline
ステント	stent
ストップウォッチ	stopwatch
ストリングス	strings
スリラー	thriller
センシティブ	sensitive
ソルバー	solver
タルコフスキー	Tarkovsky
チャイナタウン	Chinatown
ティルマン	Tilman
ディシプリン	discipline
デジャビュ	deja vu
デュオフォールド	Duofold
トラディショナル	traditional
ドリー	dolly
ドリーミング	dreaming
ドロン	Delon
ハリエット	Harriet
パティオ	patio
パーセル	parcel
ファンキー	funky
フィオレンティーナ	Fiorentina
フェルミ	Fermi
フランボワーズ	framboise
フープ	hoop
ブラウニー	brownie
ブレトンウッズ	Bretton Woods
プリウス	Prius
ペチュニア	petunia
ホーン	Hoorn
ボーイト	Boito
マジョリティー	majority
マングローブ	mangrove
ミキシング	mixing
ミスト	mist
ミッドナイト	midnight
ミニスカ	miniskirt
ミュート	mute
ミルズ	Mills
ムーラン	moulin
メルクマール	Merkmal
ライジング	rising
ランチャー	launcher
リンケージ	linkage
ルイージ	Luigi
ルルー	Leroux
レイアード	Layard
レキシントン	Lexington
アバタ	arbuda
アルフレード	Alfredo
ウィルズ	Wills
ウェーク	wake
ウラジーミル	Vladimir
ウーファー	woofer
エートス	ethos
オブライエン	O'Brien
オルレアン	Orleans
カマンベール	Camembert
カメルーン	Cameroun
キャプション	caption
ギー	ghee
グラファイト	graphite
グルー	glue
ケット	blanket
サイホン	siphon
サンドニ	Saint Denis
シアーズ	Sears
システマチック	systematic
シャモ	samo
シンバル	cymbal
シンメトリー	symmetry
スフィンクス	sphinx
セパレート	separate
ソドム	Sodom
ソレル	Sorel
タバスコ	Tabasco
タンギング	tonguing
ターフ	turf
ダニロフ	Danilov
チャンドラー	Chandler
チロシン	tyrosine
チーズバーガー	cheeseburger
トカマク	Tokamak
ナポリタン	napolitain
ネアンデルタール	Neanderthal
ハイパーリンク	hyperlink
ハニカム	honeycomb
バイブレーション	vibration
バングル	bangle
パディントン	Paddington
パトリオット	patriot
ビクトリー	victory
フィヨルド	fjord
ブランケット	blanket
プラトニック	Platonic
ヘドウィグ	Hedwig
ベジェ	Bezier
ベースライン	baseline
ペーパーバック	paperback
ホラス	Horace
ポラリス	Polaris
ミノー	minnow
ミーム	Miim
メディシン	medicine
メロー	mellow
モノグラム	monogram
ラウレンティウス	Laurentius
リキエル	Rykiel
リムーバー	remover
ルックアップ	lookup
レード	raid
アイロニー	irony
アンダーライン	underline
アーデン	Arden
インカム	income
インダス	Indus
エステート	estate
エンデバー	endeavor
オステオパシー	Osteopathy
オナ	onanie
カブン	coven
カメハメハ	Kamehameha
カヤック	kayak
クイディッチ	Quidditch
クーロン	coulomb
コスモポリタン	cosmopolitan
コット	cot
シッカート	Schickard
シャガール	Chagall
ジオラマ	diorama
ジキル	Jekyll
ジュライ	July
スターン	Stern
スワロー	swallow
セントレア	Centrair
ソアラー	soarer
チュートリアル	tutorial
チョッパー	chopper
ツンドラ	tundra
ティルト	tilt
テーベ	Thebes
デリカシー	delicacy
トゥエルブ	twelve
トゥーリー	Tooley
トルネード	tornado
トレンディー	trendy
トレーシング	tracing
ドミニカ	Dominica
ナミビア	Namibia
ナーガ	Naga
バーベル	barbell
パンチャーヤット	Panchayati
ヒュッテ	Hutte
ピアース	Pearce
ピッケル	Pickel
ピョートル	Pyotr
フロマージュ	fromage
フンボルト	Humboldt
ブラフマン	brahman
ブルペン	bullpen
プロキシー	proxy
ヘーゼルナッツ	hazelnuts
ベルゲン	Bergen
ペグ	peg
ホスピタル	hospital
ホーリー	holy
ボルフガング	Wolfgang
マカフィー	McAfee
マジシャン	magician
マジョルカ	Majorca
マッケイ	McCay
モノマー	monomer
モンパルナス	Montparnasse
ラグラン	raglan
ラシュワン	Rashwan
ラドン	radon
リフティング	lifting
リプトン	Lipton
ルミネ	LUMINE
レジュメ	resume
レメディー	remedy
ロッテルダム	Rotterdam
ロレアル	Loreal
ローズヒップ	rosehip
アイスナー	Eisner
アステカ	Azteca
アニメーター	animator
アフレコ	after recording
アルベルティ	Alberti
アントワープ	Antwerp
ウエザー	weather
エステティック	esthetique
エチュード	etude
エバン	Evan
エフェクター	effector
オテロ	Otello
オリジン	origin
オリベイラ	Oliveira
カザルス	Casals
カタルシス	katharsis
カルフール	carrefour
カンテラ	kandelaar
ガードル	girdle
キャノピー	canopy
キリマンジャロ	Kilimanjaro
クオーツ	quartz
クリエーション	creation
ケロイド	Keloid
コンセーユ	conseil
コンポスト	compost
サブユニット	subunit
シェーカー	shaker
シマンテック	Symantec
シュレディンガー	Schrodinger
シュンペーター	Schumpeter
スキーマ	schema
ステール	stere
ストーンヘンジ	Stonehenge
ソーリー	sorry
タジク	Tadzhik
ダイナモ	dynamo
ダフネ	Daphne
チャコ	chalk
テリーヌ	terrine
テート	Tate
ディドロ	Diderot
ディビジョン	division
トルティーヤ	tortilla
トレジャー	treasure
トレック	trek
ドラスティック	drastic
ドーバー	Dover
ナップザック	knapsack
ノワール	noir
ハバロフスク	Khabarovsk
パーラー	parlor
ピタゴラス	Pythagoras
ピューマ	puma
ピラティス	Pilates
ファンタスティック	fantastic
フォトグラフ	photograph
フローチャート	flowchart
ブリー	bully
ホームシック	homesick
ポンチョ	poncho
マンタ	manta
ミュータント	mutant
モロー	Moreau
モールス	Morse
ラスク	rusk
ラフォーレ	La foret
ラフマニノフ	Rakhmaninov
リセ	lycee
リットン	Lytton
リフレクソロジー	reflexology
ルブラン	Leblanc
レトロウイルス	retrovirus
ロシアン	Russian
ロンメル	Rommel
ロンリー	lonely
ローバー	rover
アテンダント	attendant
アプワイザー	Apuweiser
アーレント	Arendt
イオニア	Ionia
イザーク	Isaac
ウイッチ	witch
ウジュード	wujud
エボリューション	evolution
オフィーリア	Ophelia
オーサー	author
カイヨワ	Caillois
カポネ	Capone
カルボナーラ	carbonara
キャバ	cabaret
キュリー	Curie
キングダム	kingdom
グラスゴー	Glasgow
ケンタウルス	Centaurus
コロイド	colloid
コンディショニング	conditioning
コントラバス	Kontrabass
コンピテンシー	competency
コーンスターチ	cornstarch
サクソン	Saxon
サラセン	Saracen
サリチル	Salizyl
サントス	Santos
サンルーム	sunroom
シチズン	citizen
シュプール	Spur
スティンガー	stinger
タウト	Taut
チアミン	thiamine
チャコール	charcoal
ティラミス	tiramisu
デニッシュ	Danish
デリダ	Derrida
トゥルニエ	Tournier
トリマー	trimmer
ネプチューン	Neptune
ネーデルランド	Nederlanden
ハレー	Halley
バックハンド	backhand
バーチ	birch
バートフス	Bartfuss
パイソン	python
パドメ	Padme
パリス	Paris
ヒッチハイク	hitchhike
ビアズリー	Beardsley
ビフテキ	bifteck
ビリッチ	Bilic
ファット	fat
ファム	femme
フェイント	feint
フォーリン	foreign
フリゲート	frigate
フリスビー	Frisbee
ブロマイド	bromide
ベルナー	Werner
ペイメント	payment
ペレ	Perret
ホッブズ	Hobbes
ホブソン	Hobson
ホルムアルデヒド	formaldehyde
ホログラム	hologram
ボマー	bomber
マクリーン	Maclean
マッコール	McCall
マニピュレーター	manipulator
マルチーズ	Maltese
メセナ	mecenat
モラビア	Moravia
モールド	mold
ラスパイレス	Laspeyres
ラッド	lad
リトミック	rythmique
レシピエント	recipient
ロデオ	rodeo
アウトリガー	outrigger
アミラーゼ	amylase
アルキル	alkyl
ウォーターハウス	Waterhouse
エストニア	Estonia
オカリナ	ocarina
オッペンハイマー	Oppenheimer
オブラート	oblaat
オータム	autumn
カオリン	kaolin
カシュガル	Kashgar
ガラム	garam
ガーン	Garn
キール	keel
ギニア	Guinea
クフ	Khufu
クリッパー	clipper
クロノグラフ	chronograph
グスマン	Gusmao
グロッタ	grotta
ケイレイ	Cayley
コンシェルジュ	concierge
コンバート	convert
ゴダン	Godin
サナトリウム	sanatorium
サボタージュ	sabotage
サルコイドーシス	sarcoidosis
サージェント	Sargent
シェエラザード	Scheherazade
シニフィエ	signifie
シュベーアテ	Schwerte
ジャンカルロ	Giancarlo
ジューサー	juicer
スラング	slang
スリーパー	sleeper
センセーション	sensation
ソーサー	saucer
ダックスフント	Dachshund
チョーカー	choker
テレジア	Teresa
ディロン	Dillon
デレク	Derek
トップレス	topless
トラバース	traverse
ドンマイ	don't mind
ナイアシン	niacin
ハイター	heiter
ハレ	Halle
バリモア	Barrymore
バーキン	Birkin
バーター	barter
パードレ	padre
ビエンチャン	Vientiane
ビギン	begin
ビブラート	vibrato
ピスタチオ	pistachio
ファビエンヌ	Fabienne
フルクトース	fructose
フーバー	Hoover
ブックレット	booklet
ブラウニング	Browning
ブラスター	blaster
ブリザード	blizzard
ブリストル	Bristol
プアー	poor
ヘクター	Hector
ベルクソン	Bergson
ベンゲル	Wenger
ホータン	Khotan
ボルテージ	voltage
マカ	maca
マゼンタ	magenta
ミニマル	minimal
モト	motor
ヤスパース	Jaspers
ラザーニャ	lasagna
ロゼット	rosette
ローチ	roach
アクセシビリティー	accessibility
アジャスター	adjuster
アナン	Annan
アヌス	anus
アラゴン	Aragon
アンバサダー	ambassador
イリイチ	Illich
インストーラー	installer
イーサー	ether
ウラニウム	uranium
エクスチェンジ	exchange
エドモンド	Edmond
エレファント	elephant
エレミヤ	Jeremiah
オキシド	oxide
オーガスタ	Augusta
オーバーフロー	overflow
カザフ	Qazaq
カシス	cassis
カンディンスキー	Kandinskii
カントール	Cantor
カーペンター	Carpenter
ガスケット	gasket
キャスパー	Casper
キュイジーヌ	cuisine
クラウディウス	Claudius
クラレンス	Clarence
クリケット	cricket
クリスピー	crispy
ケトアシドーシス	ketoacidosis
ゲーデル	Goedel
コンドロイチン	chondroitin
コンパネ	control panel
コンペイトー	confeito
サラウンド	surround
サルーン	saloon
サント	Sainte
シェルパ	Sherpa
シュノーケリング	snorkeling
スターク	Stark
スペクトラム	spectrum
スリープ	sleep
スレート	slate
ダール	Dahl
チーター	cheetah
ツバイク	Zweig
テアトル	theatre
ティースプーン	teaspoon
トーキー	talkie
ナイトメア	nightmare
ナーバス	nervous
ニュースキャスター	newscaster
ニルバーナ	nirvana
ハイブッシュ	highbush
バズーカ	bazooka
バリチェロ	Barrichello
バロー	Barrow
パピルス	papyrus
パラマウント	paramount
ヒヤシンス	hyacinth
ビデ	bidet
ビルバオ	Bilbao
ピス	pith
フォーブス	Forbes
フューエル	fuel
フレー	hurray
ブッキング	booking
ブラウ	Blau
ブラウズ	browse
プラウ	plow
プレステージ	prestige
プロメテウス	Prometheus
ベークド	baked
ペンネ	penne
ホイットマン	Whitman
ホレス	Horace
ホーマー	homer
ホームタウン	hometown
ボヘミアン	Bohemian
マインツ	Mainz
メイズ	maze
モンデオ	Mondeo
ヨハネスブルク	Johannesburg
ラグーン	lagoon
ラピス	lapis
ランサー	lancer
リフレイン	refrain
リプ	replay
リーズ	Leeds
ルーセント	lucent
レック	wreck
レモネード	lemonade
レーション	ration
ワラント	warrant
ワルサー	Walther
ワルラス	Walras
アウトカム	outcome
アクアマリン	aquamarine
アクスル	axle
アタッチメント	attachment
アニオン	anion
アリシア	Alicia
アルビレックス	albirex
アルミナ	alumina
アンフェア	unfair
アンベードカル	Ambedkar
イソフラボン	isoflavone
イプセン	Ibsen
インストルメント	instrument
エミッション	emission
エンベロープ	envelope
カサ	casa
カタリ	cathares
カツレツ	cutlet
ガーター	garter
クラウド	crowd
クレンザー	cleanser
グッピー	guppy
ケミストリー	chemistry
ケーリー	Cary
ゲッチュ	get you
コングロマリット	conglomerate
サフィン	Safin
サブレー	sable
サラリー	salary
サンク	cinq
サンボ	sambo
サーブレット	Servlet
シェーバー	shaver
シャブリ	Chablis
シルビオ	Silvio
ジェラシー	jealousy
ジュラシック	Jurassic
ジークフリート	Siegfried
スカッシュ	squash
スカッド	scud
スチューデント	student
スフレ	souffle
スプラッシュ	splash
スーク	suq
タクト	tact
ダマスカス	Damascus
チノ	chino
トップコート	topcoat
トリハロメタン	trihalomethane
トロット	trot
ドアノブ	doorknob
ニム	nim
ノンブル	nombre
ハートフォード	Hartford
ハーブスマン	Herbsman
バッジョ	Baggio
バントゥイユ	Vinteuil
パーマネント	permanent
ヒューゴー	Hugo
ヒルデガルト	Hildegard
ビュルガー	Burger
ピンキー	pinkie
フェンディー	Fendi
フライブルク	Freiburg
フリン	Flynn
ブチル	butyl
プライ	ply
プライマー	primer
プランタン	printemps
プロスタグランジン	prostaglandin
ホバリング	hovering
ボアソナード	Boissonade
マウントバッテン	Mountbatten
マリッジ	marriage
マルガレーテ	Margarete
ミヒャエル	Michael
メジアン	median
メーキャップ	makeup
ラマダン	Ramadan
ラングーン	Rangoon
ラーソン	Larson
リアリスト	realist
リザード	lizard
リヤド	Riyad
レイシー	Lacy
レーム	lame
ワードローブ	wardrobe
アイダホ	Idaho
アカウンタビリティー	acountability
アドリアン	Adrian
アナーキスト	anarchist
アメリ	Amelie
アラ	alla
アンフォラ	amphora
イスラマバード	Islamabad
イレ	irae
インターバンク	interbank
イントラネット	intranet
イーゼル	easel
ウォルツ	Waltz
エクレア	eclair
エンカウンター	encounter
オケ	orchestra
オマージュ	hommage
オルサッティ	Orsatti
カストリアディス	Castoriadis
カメラワーク	camerawork
カラヤン	Karajan
カートン	carton
キートン	Keaton
ギンガム	gingham
ギンズバーグ	Ginsberg
クレーマー	claimer
グラフト	graft
ゲゼルシャフト	Gesellschaft
ゲッティンゲン	Gottingen
コザ	Koza
コスメチック	cosmetic
コラボレート	collaborate
コンバージョン	conversion
コーギー	corgi
コーディネーション	coordination
コーネリアス	Cornelius
ゴーチエ	Gautier
サイクロトロン	cyclotron
サディスティック	sadistic
サラグ	sarag
サルモネラ	salmonella
シェリング	Schelling
シロッコ	sirocco
シンキング	thinking
ジャマール	Jamal
ジャンピング	jumping
ジュード	Jude
スキャンダラス	scandalous
ストリッパー	stripper
スメタナ	Smetana
ズレータ	Zuleta
セスナ	Cessna
セパレーター	separator
セレナーデ	Serenade
タブロイド	tabloid
タープ	tarp
ダッフル	duffle
ディオティーマ	Diotim
ディスカバリー	discovery
トリポリ	Tripoli
トレーサビリティー	trac-abiity
ドミグラス	demiglace
ドラコ	Draco
ノイマン	Neumann
パイロン	pylon
ビュイック	Buick
ファラデー	Faraday
ブール	boole
プリザーブド	preserved
ホトウ	Pudong
ボランタリー	voluntary
ポマード	pomade
ポリスチレン	polystyrene
マイラー	miler
マクロビオティック	macrobiotic
マコロン	macaron
マナ	mana
マハラジャ	maharaja
マム	ma'am
メニエール	Meniere
メントール	menthol
モノローグ	monologue
ランボルギーニ	Lamborghini
ラーク	lark
レングス	length
レント	lento
ロサウラ	Rosaura
ロッテリア	Lotteria
アイブロー	eyebrow
アウトバーン	Autobahn
アエネーアース	Aeneas
アシュラム	aashram
アドミラル	admiral
アナーキズム	anarchism
アバ	avatar
アフリカン	African
アラウンド	around
アーティスティック	artistic
インクライン	incline
インスパイアー	inspire
インパネ	instrumental panel
ウィルバー	Wilbur
エコシステム	ecosystem
エレクトラ	Elektra
オンブズ	ombuds
カトリシズム	Catholicism
カルバマゼピン	carbamazepine
カーリング	curling
ガナッシュ	ganache
キャトル	quatre
クロコダイル	crocodile
クローク	cloak
クローブ	clove
グラシエラ	Graciela
コーダ	coda
サイケデリック	psychedelic
サブジェクト	subject
サルバトーレ	Salvatore
ザック	Zack
シェーク	shake
シーラカンス	coelacanth
スケーティング	skating
スティーブンソン	Stevenson
セルガチョフ	Sergachou
ゼイ	they
ダイナース	Diners
ダビッドソン	Davidson
チタ	Chita
テモ	Timothy
ディケンズ	Dickens
デッカー	decker
デリック	derrick
トラクション	traction
ドギー	doggy
ネーキッド	naked
ハインツ	Heinz
ハロッズ	Harrods
ハンドボール	handball
ハース	Haas
バックパッカー	backpacker
バーミヤーン	Bamiyan
パッケージング	packaging
パテント	patent
パペット	puppet
ビシー	Vichy
ビスコンティ	Visconti
ピング	ping
フロンターレ	Frontale
プライオリティー	priority
プランク	Planck
プリオン	prion
ヘリック	Herric
ベルベル	Berber
ベルモント	Belmont
ペトリ	Petrie
ペーパーレス	paper-less
ボディコン	body conscious
ボラティリティー	volatility
ポローニアス	Polonius
マキシム	maxim
ミネアポリス	Minneapolis
メルビル	Melville
ヤコポ	Jacopo
ラグナロク	ragnarok
ラダー	ladder
レスポール	Les Paul
ロッシュ	Roches
ワイオミング	Wyoming
ワイルダー	Wilder
アセロラ	acerola
アドミニストレーション	administration
アナーキー	anarchy
アニミズム	animism
アビ	habit
アベンジャー	avenger
アモルファス	amorphous
アルカディア	Arkadia
アルテッツァ	altezza
アーガイル	argyle
イングーシ	Ingush
インジェクター	injector
イーサン	Ethan
イーター	eater
ウイークエンド	weekend
ウズベク	Uzbek
オピオイド	opioid
オンボード	onboard
カッテージ	cottage
カットオフ	cut-off
カンター	canter
ガムラン	gamelan
ギミック	gimmick
ギロチン	guillotine
クレマチス	Clematis
クロスオーバー	crossover
グルコサミン	glucosamine
グレゴリオ	Gregorio
グロムイコ	Gromyko
コンデンス	condense
コーンフレーク	cornflake
サタデー	Saturday
サボア	Savoie
シャラポワ	Sharapova
ショクリ	Chokri
シームレス	seamless
ジストロフィー	dystrophy
ジョブズ	Jobs
ジングル	jingle
スウィフト	Swift
スプール	spool
スペード	spade
セニョール	senor
ソーン	Thorne
タイタン	Titan
チュービンゲン	Tubingen
チョムスキー	Chomsky
ツーリスモ	turismo
テンプ	temp
ディスクリート	discrete
ディストリビューション	distribution
トレローニー	Trelawney
トング	tongs
トーキング	talking
ドゥカティ	Ducati
ナイチンゲール	Nightingale
ヌクレオチド	nucleotide
ハザリー	Hatherley
バルフォア	Balfour
パネラー	paneler
パピヨン	papillon
パワーズ	Powers
パンプキン	pumpkin
ピクチャレスク	picturesque
ピーラー	peeler
フィード	feed
フロド	Frodo
ブリンク	blink
プリミティブ	primitive
ベルマーレ	Bellmare
ベローナ	Verona
ボーキサイト	bauxite
ポトフ	pot-au-feu
マンダリン	mandarin
ミオ	mio
モック	mock
モラーヌ	Morane
ランカスター	Lancaster
ラージャ	raja
リシン	lysine
リッチモンド	Richmond
リトマス	litmus
リベリア	Liberia
ルサンチマン	ressentiment
アッサム	Assam
アップライト	upright
アビー	abbey
アモス	Amos
アユタヤ	Ayutthaya
アルキメデス	Arkhimedes
アンタイド	untied
イエナ	Jena
イオ	io
イリジウム	iridium
インテンシティー	intensity
インディア	India
ウィントン	Winton
エアポート	airport
エクリプス	Eclipse
エトワール	etoile
エルベ	Elbe
エンターテイナー	entertainer
エーデルワイス	Edelweiss
オニックス	onyx
カイロプラクティック	chiropractic
カナート	qanat
カベルネ	Cabernet
ガトウ	Guadalcanal
クルーン	Kroon
グリフィス	Griffis
グレーン	grain
ケンジントン	Kensington
コルシカ	Corsica
コンドル	condor
ゴブレット	goblet
シュッド	should
シュレーダー	Schroder
ジョット	Giotto
スチレン	styrene
ステディー	steady
スプレッドシート	spreadsheet
スローン	Sloan
セツルメント	settlement
ソブリン	sovereign
タガログ	Tagalog
タデウス	Tadeusz
タンホイザー	Tannhauser
ツーカー	TU-KA
ディスクール	discours
ディレー	delay
デシベル	decibel
デポ	depot
デンドライト	dendrite
デービー	Davy
トマホーク	Tomahawk
トルエン	toluene
トルキスタン	Turkestan
トーション	torsion
ドトール	doutor
ナンバリング	numbering
ネブラスカ	Nebraska
バスタ	Busta
バンズ	buns
パンタロン	pantalon
ビハインド	behind
フィッティング	fitting
フィレオ	filet-o
フェンタニル	fentanyl
フォレスター	forester
フラム	Fulham
フルール	fleur
ブカレスト	Bukarest
ブラジリア	Brasilia
ブランクーシ	Brancusi
ブリック	brick
ブレークスルー	breakthrough
ブローニュ	Boulogne
プリンシパル	principal
プロラクチン	prolactin
ヘイドン	Hayden
ボルコフ	Volkov
ボーク	balk
ポゴ	pogo
ポリヌクレオチド	polynucleotide
ポロック	Pollock
マクニコル	MacNicol
マチス	Matisse
マックイーン	McQueen
マルガリーナ	Margarina
マルチネ	Martinet
マレット	mallet
マンモグラフィー	mammography
モヘア	mohair
モンテネグロ	Montenegro
ヨブ	Job
ラックス	lux
ラパン	Lapin
ラブコメ	love comedy
ラブラドール	Labrador
リエンジニアリング	reengineering
リストランテ	ristorante
リッシェ	riche
ルドガー	Ludger
ルーマン	Luhmann
ルーラー	ruler
ローレライ	Lorelei
ワイル	Weil
ワッシャー	washer
アガタ	agata
アキノ	Aquino
アナモルフォーズ	anamorphose
アニエス	Agnes
アポイントメント	appointment
アルカロイド	alkaloid
イスト	#ИМЯ?
イタリック	italic
イドラ	idola
インキュベーター	incubator
インターロイキン	interleukin
インディビジュアル	individual
ウォード	Ward
ウルカヌス	Vulcanus
エイゼンシュテイン	Eisenstein
エスペラント	esperanto
エンリケ	Enrique
オイリー	oily
オキシ	oxy
オーウェル	Orwell
オーバーレイ	overlay
オーレ	ole
カービン	carbine
キチン	chitin
キノン	quinone
キーマ	keema
クオータ	quota
クラブサン	clavecin
クリッピング	clipping
クロカン	ross-country
コストコ	Costco
コッド	Cod
コンバット	combat
コーシー	Cauchy
サブカルチャー	subculture
サミュエルソン	Samuelson
サリドマイド	thalidomide
シアヌーク	Sihanouk
シャイン	shine
シャルトル	Chartres
シュタット	stadt
シュトラスブルク	Strassburg
シンハ	singha
ジアゼパム	diazepam
ジェーエフケー	JFK
ジッポ	Zippo
ジャスティス	justice
ジャーキー	jerky
ジルコニア	zirconia
スキム	skim
ステイン	stain
ストリックランド	Strickland
スループット	throughput
センシング	sensing
ゼノン	Zenon
ソルジャー	soldier
タゴール	Tagore
タラント	talanton
タータン	tartan
ダイス	dies
ダイチ	Deitch
ダイヤグラム	diagram
チェット	Chet
チェンバー	chamber
チン	tin
テキーラ	tequila
テレマン	Telemann
トリビューン	tribune
トリプトファン	tryptophan
ドゥンガ	Dunga
ドレナージ	drainage
ナショナリスト	nationalist
ニューロ	neuro
ハイク	hike
バイア	Bahia
バッカー	backer
バーデン	Baden
パタゴニア	Patagonia
パップ	pap
パラミデュース	Palamedes
パンツァーファウスト	Panzerfaust
パントマイム	pantomime
ヒス	Hysterie
ヒラソル	girasol
フェントン	Fenton
フォンデュ	fondue
フラウ	Frau
フリート	fleet
ブレックファースト	breakfast
ブロンクス	Bronx
プッチーニ	Puccini
ヘッドセット	headset
ホルス	Horus
ボラ	Bora
ボーグ	vogue
ポルカ	polka
マター	matter
マラケシュ	Marrakesh
マーチャンダイジング	merchandising
ミルン	Milne
ムフ	Mouffe
メソジスト	Methodist
モッセ	Mosse
モンゴメリー	Montgomery
ライスケ	Reiske
ラジアル	radial
ラティス	lattice
ラモン	Ramon
リアクタンス	reactance
リーゼント	regent
レッカー	wrecker
ロリータ	Lolita
ワース	worse
アウレリウス	Aurelius
アディ	ady
アフェアー	affair
アリコ	Alico
ウイッグ	wig
ウエス	waste
ウォットン	Wotton
エクセレンス	excellence
エコール	ecole
エスカルゴ	escargot
エスパー	esper
エメット	Emmett
オキシダーゼ	oxidase
オニール	O'Neill
カタリーナ	Catalina
カプサイシン	capsaicin
カルビン	Calvin
カルメラ	caramelo
ガンビア	Gambia
キャッチング	catching
キャラウェイ	caraway
クネヒト	Knecht
グアバ	guava
グラインダー	grinder
コレット	Collette
コンスタンチン	Constantin
コンスタンツェ	Constanze
コーチン	cochin
サディズム	sadism
サハ	Sakha
シオニスト	Zionist
シュア	sure
ジェナ	Jenna
ジェノサイド	genocide
スクリード	Screed
スクロース	sucrose
スパニッシュ	Spanish
スラー	slur
スール	sur
タウヒード	tawhid
タスポ	ｔａｓｐｏ
タリム	Tarim
チチコフ	Chichkov
チャウシェスク	Ceausescu
ツァラトゥストラ	Zarathustra
トーマ	Thoma
ネワール	Newa
ハイネ	Heine
バトー	Watteau
バージェス	Burgess
バーモント	Vermont
パットン	Patton
パラグライダー	paraglider
ヒッチ	hitch
ビジョナリー	visionary
ピグマリオン	Pygmalion
フォークロア	folklore
フラクタル	fractal
フリクション	friction
フリージア	freesia
フリーハンド	freehand
フローレンス	Florence
ブギ	boogie
ブラッド	blood
プリインストール	preinstall
プログレス	progress
ヘッドライン	headline
ヘパリン	heparin
ベドウィン	Bedouin
ベンフィカ	Benfica
ペディキュア	pedicure
ペルセウス	Perseus
ホリスティック	holistic
ボンゴレ	vongole
ボーテ	beaute
ボールト	vault
ポトマック	Potomac
ポリペプチド	polypeptide
マイクロホン	microphone
マルティ	Marti
マンスリー	monthly
ミネストローネ	minestrone
ムーニー	Mooney
メディケア	Medicare
モスリン	muslin
モノ	mono
モノグラフ	monograph
ユーディット	Judit
ライニング	lining
ラインハルト	Reinhard
ラナンキュラス	Ranunculus
リポ	lipo
ルコント	Lecomte
ルミナリエ	luminarie
ワール	wal
アイーダ	Aida
アクアビクス	aquavics
アルキ	Harki
アルブ	Albu
アレグロ	allegro
イヌイット	Inuit
イミテーション	imitation
ウィリス	Willis
ウラノス	Ouranos
エイダ	Ada
エンコーディング	encoding
オベリスク	obelisk
オルソ	ortho
オーラス	all last
ガルフ	gulf
ガルボ	Garbo
ガーデナー	gardener
キシリトール	xylitol
キナ	Kina
キューティクル	cuticle
ギャンブラー	gambler
クリムソン	crimson
クレアチニン	creatinine
クロッカス	crocus
グルカン	glucan
ケインジアン	Keynesian
ケーディス	Kades
ゲッベルス	Goebbels
コミュニケート	communicate
コーポ	corporate house
ゴング	gong
ササン	Sasan
サザーランド	Sutherland
サービスマン	serviceman
シャイニング	shining
シャレード	charade
シャーレ	Schale
シュトゥットガルト	Stuttgart
シルト	silt
ジャララバード	Jalalabad
スコアリング	scoring
スタッグ	stag
ステン	soutien
ストーク	stork
スニフ	Sniff
スプロール	sprawl
スペシャリティー	specialty
スポイル	spoil
スポルティーボ	sportivo
セルジューク	Seljuk
セーシェル	Seychelles
タラゴン	tarragon
チトー	Tito
チャンプ	champ
テニアン	Tinian
テースティング	tasting
ディレクション	direction
デウス	Deus
トポロジー	topology
トルソー	torso
トーチカ	tochka
ニアレスト	nearest
ノロウイルス	Norovirus
ノーラン	Nolan
ハズ	husband
ハンチ	haunch
ハンドベル	handbell
バウアー	Bauer
ヒューリスティック	heuristic
ファンクショナル	functional
フィッツジェラルド	Fitzgerald
フォアハンド	forehand
フローラン	Florent
プルートー	Pluto
ヘイリー	Hailey
ヘルダー	Herder
ヘルムホルツ	Helmholtz
ベガ	Vega
ベンジン	benzine
ベント	bent
ホーソーン	Hawthorne
ボガート	Bogart
ボーボワール	Beauvoir
ポアンカレ	Poincare
マクゴナガル	McGonagall
マクミラン	Macmillan
マジェ	majesty
マリーシア	malicia
マルキシズム	Marxism
ミケーネ	Mycenae
ムンド	mundo
モーターカー	motorcar
モーパッサン	Maupassant
ユッカ	yucca
ラスボス	last boss
ラツィオ	Lazio
ラーガ	raga
リザルト	result
リトグラフ	lithograph
リュート	lute
リューベック	Lubeck
リリエンタール	Lilienthal
ルクス	Lux
ルッコラ	rucola
レシプロ	reciprocating
レーベン	Leben
ロッソ	Rosso
ローヌ	Rhone
アテンション	attention
アナザー	another
アブストラクト	abstract
アミド	amido
アルギン	algin
アルファルファ	alfalfa
アロケーション	allocation
ウィルクス	Wilkes
ウエーティング	waiting
エコロジカル	ecological
エフライム	Ephraim
エメルソン	Emerson
エンゲル	Engel
オキシドール	oxydol
オフショア	offshore
オペル	Opel
オーディエンス	audience
オールウェーズ	always
ガッシュ	gouache
ガルブレイス	Galbraith
クラビーア	Klavier
クレスト	crest
クレッシェンド	crescendo
グウィネス	Gwyneth
コリジョン	collision
コンティ	Conti
コンポジット	composite
ゴーゴリ	Gogol
ゴート	goat
サラトガ	Saratoga
サントリーニ	Santorini
サーマル	thermal
シアー	seer
シェワルナゼ	Shevardnadze
シャペロン	chaperone
シャングリラ	Shangri La
シュナーベル	Schnabel
シュノーケル	Schnorchel
シリンジ	syringe
シンカー	sinker
シーマン	Seaman
ジェム	gem
スタンドオフ	stand-off
スピーク	speak
セサール	Cesar
ソーイング	sewing
タコス	tacos
タルコーニ	Tarconi
ダージリン	darjeeling
チェチリア	Cecilia
チュニス	Tunis
チュー	Chou
チンダル	Tyndale
ティールーム	tearoom
テレメーター	telemeter
テレーズ	Therese
デカダンス	decadence
デュルケーム	Durkheim
トオリル	To'oril
トランスジェニック	transgenic
トレゼゲ	Trezeguet
ドブソン	Dobson
ナックル	knuckle
ハープシコード	harpsichord
バオバブ	baobab
バカラ	Baccarat
バセット	basset
ババロア	bavarois
バンドワゴン	bandwagon
パーキンズ	Perkins
ビスフェノール	bisphenol
ビヒクル	vehicle
ビビアーニ	Viviani
ピジョン	pigeon
ピピン	Pippin
ピリニャーク	Pilniak
ピレネー	Pyrenees
ファンタジア	fantasia
フォレット	Follett
フラバンジェノール	flavangenol
フリック	Flick
フロック	frock
ブリタニア	Britannia
ブーゲンビレア	bougainvillea
プラグマティズム	pragmatism
プリン	purine
ヘキサ	hexa
ベッキオ	vecchio
ペアレント	parent
ペシミズム	pessimism
ペッティング	petting
ペネロペ	Penelope
ホジキン	Hodgkin
ホームルーム	homeroom
ボツリヌス	botulinus
ボーロ	bolo
ポプリ	potpourri
ポンパドゥール	pompadour
マカダミア	Macadamia
マセラティ	Maserati
マドラス	Madras
マロニエ	marronnier
マーヤー	maya
ムービング	moving
メスシリンダー	MeBzylinder
メラノサイト	melanocyte
メリーゴーランド	merry-go-round
モレ	mole
ユニゾン	unison
ラウラ	Laura
ランバート	Lambert
リタイアメント	retirement
リビエラ	Riviera
リベット	rivet
リレーショナル	relational
ルチル	rutile
ルビッチ	Lubitsch
レクチン	lectin
レティシア	Leticia
アイル	isle
アクバル	Akbar
アゴラ	agora
アセチレン	acetylene
アセンション	ascension
アリシン	allicin
アンダマン	andaman
アンダンテ	andante
イートン	Eton
イールド	yield
ウィンチェスター	Winchester
ウバイド	Ubaid
エクステンション	extension
エミュレーター	emulator
エリテマトーデス	erythematodes
エルリク	Erlik
エンボス	emboss
オリンポス	Olympos
カウアイ	Kauai
カッセル	Kassel
カルキ	kalk
カンタベリー	Canterbury
カンパリ	campari
カンブリア	Cambria
カーフ	calf
ガゼル	gazelle
クリッカー	clicker
クリー	Cree
クワイア	choir
グロース	growth
グローリー	glory
グール	ghoul
ゲルデラー	Goerdeler
コジェネレーション	cogeneration
コドン	codon
コメット	comet
コロシアム	coliseum
コロニアル	colonial
コンバイン	combine
コンフィ	confit
コンフュージョン	confusion
サセックス	Sussex
サターン	Saturn
サディスト	sadist
サンタナ	Santana
ザグレブ	Zagreb
シェストフ	Shestov
シェーンベルク	Schonberg
シナトラ	Sinatra
シュティルナー	Stirner
シルベスター	Sylvester
ジグムント	Zygmunt
ジムカーナ	gymkhana
スカイダイビング	skydiving
スキッパー	skipper
スラローム	slalom
スリザリン	Slytherin
セリン	serine
チミン	thymine
チャップマン	Chapman
チャツネ	catni
テレイグジスタンス	telexistence
テレフンケン	Telefunken
トキソイド	toxoid
トンエスダブリューユー	TonSWU
ドーマン	Doman
ナスカ	Nazca
ニグロ	negro
ニコルス	Nichols
ニューカッスル	Newcastle
ネスカフェ	Nescafe
ノリス	Norris
ハルゼー	Halsey
ハルト	halt
ハントケ	Handke
バイソン	bison
バズ	buzz
バッテラ	bateira
バークシャー	Berkshire
パニエ	pannier
パブリッシング	publishing
パンチング	punching
ビトルビウス	Vitruvius
ビバルディ	Vivaldi
フェイル	fail
フォトン	photon
フォールス	FALSE
ブラフマー	Brahma
ブリュンヒルド	Brunhild
プラット	Platt
プレーリー	prairie
プロトン	Proton
ベイブ	babe
ペイトン	Paton
ホエール	whale
ホメイニ	Khomeini
ホレイシオ	Horatio
ボダ	Boda
ボッティチェリ	Botticelli
ポポロ	popolo
ミニバス	minibus
ミラージュ	mirage
モンテッソリ	Montessori
モートン	Morton
ラスコーリニコフ	Raskolnikov
リダクション	reduction
リノリウム	linoleum
リパーゼ	lipase
リフィル	refill
リムーバブル	removable
ルンバ	rumba
レッサー	lesser
レンネンカンプ	Lennenkampf
ロッサ	rossa
ロバートソン	Robertson
ローデシア	Rhodesia
ロールズ	Rawls
アイム	'm
アシスタンス	assistance
アスコルビン	ascorbic
アスター	aster
アデノシン	adenosine
アトミック	atomic
アニス	anise
アマポーラ	Amapola
アルパイン	Alpine
アルビーノ	albino
アンタッチャブル	untouchable
イグアナ	iguana
イネス	Innes
インジェクション	injection
インテグレーション	integration
インテリゲンチャ	intelligentsiya
インボイス	invoice
ウェストン	Weston
ウエルネス	wellness
エゴン	Egon
エスメラルダ	Esmeralda
エルトン	Elton
エレクトロン	electron
エンドソーム	endosome
オイラー	Euler
オウン	own
オルドー	Ordo
オートミール	oatmeal
カイテル	Keitel
カナール	canard
カブリオレ	cabriolet
カラチ	Karachi
カーシュ	Kersh
カーマ	kerma
ガリウム	gallium
ギイ	Guy
クアハウス	Kurhaus
クインシー	Quincy
クライテリア	criteria
クロスワード	crossword
クロマトグラフィー	chromatography
クロル	Chlor
グロリア	gloria
コキュ	cocu
コレジオ	collegio
コロンボ	Colombo
コンダクター	conductor
コンドルセ	Condorcet
コーディング	coding
サルベージ	salvage
サーモ	thermo
シスプラチン	cisplatin
シーケンサー	sequencer
ジェロニモ	Geronimo
スケルツォ	scherzo
スターダスト	stardust
スターティング	starting
スチムソン	Stimson
ストライド	stride
ストークス	Stokes
スバ	Suva
スライサー	slicer
スーパーチャージャー	supercharger
セサミ	sesame
セレブリティー	celebrity
ソフィーナ	Sofina
ターキー	turkey
ダイマー	dimer
ダフ	duff
チェロキー	Cherokee
チャウダー	chowder
ツァンポ	Tsangpo
ティチアーノ	Tiziano
ティラノサウルス	Tyrannosaurus
ティーチャー	teacher
テオフィリン	theophylline
テクニシャン	technician
ディジョン	Dijon
ディナール	dinar
デフォー	Defoe
デューラー	Durer
トゥイーン	tween
トライオン	Tryon
トリエステ	Trieste
トークン	token
ドルチェ	dolce
ドードー	dodo
ナック	nack
ナード	nerd
ニトログリセリン	nitroglycerine
ハラー	Haller
ハルドゥーン	Khaldun
ハンカチーフ	handkerchief
バウンス	bounce
バル	Val
バーンスタイン	Bernstein
パスキン	Pascin
ヒメネス	Jimenez
ピート	peat
フィリー	filly
フィージビリティー	feasibility
フォクストン	Foxton
フォーディズム	Fordism
フレーゲ	Frege
フロギストン	Phlogiston
フーゴ	Fugo
ブハーリー	Bukhari
プロップ	prop
ベリ	Verri
ベレン	Belem
ペアリング	pairing
ポスティング	posting
マクマホン	McMahon
マハティール	Mahathir
ミオグロビン	myoglobin
ムチン	mucin
メビウス	Mobius
モアイ	moai
モデラー	modeler
モンドリアン	Mondriaan
モーブ	mauve
ラザー	Rather
ランドスケープ	landscape
ラーケン	laken
リアリスティック	realistic
リンガ	lingua
リンツ	lindt
リンポチェ	Rinpoche
ルガー	Luger
ルピナス	Lupinus
レオタード	leotard
レナ	Lena
レンヌ	Rennes
ロムルス	Romulus
ロンダリング	laundering
ワー	were
アイスバーン	Eisbahn
アサルト	assault
アジャスト	adjust
アトキンソン	Atkinson
アトス	Atos/Atoz
アネックス	annex
アブサロム	Absalom
アブドゥルカシム	Abdiqassim
アマラ	Amara
アミロイド	amyloid
アラウ	Arrau
アーチャー	Archer
イコライザー	equalizer
イシュー	issue
イソ	iso
インスブルック	Innsbruck
インディアナ	Indiana
ウィッシュボーン	wishbone
ウルドゥー	Urdu
エキジビション	exhibition
エスト	est
エスニシティー	ethnicity
エドアルド	Eduardo
オラトリオ	oratorio
オリオール	oriole
カゼイン	Kasein
カディス	Cadiz
カルダモン	cardamon
カレンシー	currency
カンナ	Canna
キャッチー	catchy
キューティー	cutie
ギャロップ	gallop
クリフトン	Clifton
クルーガー	kluger
クロマトグラフ	chromatograph
クロール	crawl
グティエレス	Gutierrez
グレイン	grain
グレーテル	Gretel
コブ	Cobb
コマンダー	commander
コンポジション	composition
コージー	cozy
ゴット	got
ゴブラン	Gobelin
サイエンティフィック	scientific
サバイバー	survivor
サビーナ	Sabina
サンダース	Sanders
サーチライト	searchlight
ザカリアン	Zakarian
シアノ	cyano
シャーリーズ	Charlize
シュリンプ	shrimp
シンクレア	Sinclair
ジョクジャカルタ	Jokjakarta
スノッブ	snob
スレーヤー	slayer
ゼネラリスト	generalist
タコメーター	tachometer
タレ	talent
チェーサー	chaser
チトクロム	Cytochrom
チューバ	tuba
ツルゲーネフ	Turgenev
テレポート	teleport
デクスター	Dexter
デューティー	duty
トラフ	trough
トランジション	transition
ドネペジル	donepezil
ドミンゴ	Domingo
ドライブウエー	driveway
ドルト	Dolto
ドワイト	Dwight
ドーハ	Doha
ニヒル	nihil
ニョッキ	gnocchi
ノゲイラ	Nogueira
ノンアルコール	nonalcohol
バイオレーション	violation
バッフル	baffle
バンビ	Bambi
バートレット	Bartlett
バーン	burn
パリティー	parity
パンパ	pampa
ヒドラ	Hydra
ビエンナーレ	biennale
ビオ	bio-
ビジネスライク	businesslike
ビタ	Vita
ビフィズス	bifidus
ビーフン	bihun
ピネラ	Piniella
ファンネル	funnel
フィスク	Fisk
フィリッポ	Filippo
フェーバリット	favorite
フォルマント	formant
ブラッキー	Blackie
ブールバール	boulevard
プエブロ	pueblo
プロクシマイヤー	Proxmire
プロテオミクス	proteomics
ペタンク	petanque
ペナン	Penang
ペロポネソス	Peloponnesos
ペントハウス	penthouse
ボブ	bob
ボルヘス	Borges
ボーガン	bowgun
ポートマン	portman
マイカ	mica
マイコプラズマ	mycoplasma
ミディ	midi
メフィストフェレス	Mephistopheles
モノクローム	monochrome
モビリオ	Mibilio
モリヨン	Morillon
ラクタム	lactam
リスキー	risky
リノレン	linolen
リレバン	relationship banking
ルード	Ludo
レーガノミックス	Reaganomics
ロエベ	Loewe
ロザモンド	Rosamond
ロッシーニ	Rossini
ワーゲン	wagen
アクセラレーター	accelerator
アクロポリス	acropolis
アニムス	animus
アヌビス	Anubis
アマチュアリズム	amateurism
アメージング	amazing
アリアス	Arias
アリエス	Aries
アルカローシス	alkalosis
アレー	array
アンジェ	Angers
アーシング	earthing
アーティチョーク	artichoke
アームチェア	armchair
イノシン	inosinic
イレウス	ileus
インストルメンタル	instrumental
ウィメンズ	women's
ウェポン	weapon
エクステ	extention
エゴイスト	egoist
エスファハン	Esfahan
オ	au
オイケン	Eucken
オクトーバー	October
オランジュリー	orangerie
オンディーヌ	Ondine
オーバーコート	overcoat
オーバーラン	overrun
カウツキー	Kautsky
カチオン	Kation
カルボキシル	carboxyl
ガマ	Gama
キッチュ	Kitsch
キトサン	chitosan
キュア	cure
ギルガメシュ	Gilgamesh
クインテット	quintet
クイーンズランド	Queensland
クレードル	cradle
グラッセ	glace
グラフィカル	graphical
グロック	glock
ケータリング	catering
ケーン	kaen
コペン	Copen
コンサ	consultant
サルビア	salvia
サーフボード	surfboard
サーロイン	sirloin
シエル	ciel
シトラス	citrus
シャリーア	Shariah
シャルドネ	Chardonnay
シュシュ	scrunchy
シュバリエ	Chevalier
シュールレアリスト	surrealist
シーター	seater
ジャンガリアン	Djungarian
ジャンキー	junkie
ジュニ	Juni Cortez
ジュリアナ	Juliana
スクデット	scudetto
スケーター	skater
スタジャン	stadium jumper
スートラ	sutra
スーン	soon
セミョーノフ	Semenov
ダウンサイジング	downsizing
ダランベール	d'Alembert
ダンディズム	dandyism
チャウン	Chown
チャールストン	Charleston
チョモランマ	Chomolungma
ツァイス	Zeiss
ティース	teeth
テオティワカン	Teotihuacan
テクノクラート	technocrat
テルマ	Thelma
ディスティラリー	distillery
デイモン	Damon
トイレタリー	toiletry
トリニトロン	Trinitron
ドゥミ	demi
ナグマホン	nagmachon
ナルシシスト	narcissist
ニッセン	Nissen
ニューラル	neural
ヌーディー	nuddy
ネス	Ness
ノッチ	notch
ノルデン	norden
ハイゼンベルク	Heisenberg
ハイメ	Jaime
ハスラー	hustler
バレット	Barrett
バレンティーナ	Valentina
パオロ	Paolo
パターソン	Patterson
パラス	Pallas
パロミデス	Palomides
ヒロポン	Philopon
ピエ	pie
ピエタ	Pieta
ピューリタニズム	Puritanism
ピロー	pillow
ピンホール	pinhole
ファシリティー	facility
ファーニチャー	furniture
フィレット	fillet
フォーティー	forty
フラックス	flux
フリューゲル	Flugel
フレアー	Flair
フレール	Frere
ブタン	butane
ブラスト	blast
ブリオッシュ	brioche
ブリスベーン	Brisbane
ブレーブ	brave
ヘム	heme
ペタン	Petain
ペンクロフ	Pencroft
ホイジンガ	Huizinga
ホルスト	Holst
ポッケ	pocket
ポリペクトミー	polypectomy
ポーシャ	Portia
マサダ	Masada
マリオネット	marionnette
マリンバ	marimba
マルトース	maltose
マントラ	mantra
マール	Maar
ミゼラブル	miserable
メトリ	Mettrie
メンバーシップ	membership
モイスチャー	moisture
モディファイ	modify
ユンボ	yumbo
ラファエロ	Raffaello
ランチア	Lancia
リフレクター	reflector
リリック	lyric
ルパート	Rupert
ルーベンス	Rubens
レイオフ	lay-off
ロビン	robin
ロレッタ	Loretta
ローザンヌ	Lausanne
ローテク	low technology
ロープウエー	ropeway
ローム	loam
ローライズ	lowrise
ワーズワース	Wordsworth
アイホール	eyehole
アエネイス	Aeneis
アカンサス	Acanthus
アグ	agriculture
アディール	Adill
アトリー	Attlee
アネルギー	anergy
アメリカズ	America's
アランフェス	Aranjuez
アルキッド	alkyd
アルトゥール	Arthur
アルフォンソ	Alfonso
インパール	Imphal
インフィニティ	infinity
インプレッション	impression
ウイナー	winner
ウェッブ	Webb
ウエハース	wafers
ウーリー	woolly
エコロジスト	ecologist
エステティシャン	estheticien
エルク	elk
エンドルフィン	endorphin
オストフリースラント	Ostfriesland
オデュッセウス	Odysseus
オプティ	opti
オリエンタリズム	orientalism
オーバーハング	overhang
オーバーヘッド	overhead
カスタネット	castanet
カルカロフ	Karkaroff
カルー	Karoo
カロッツェリア	carrozzeria
カンタービレ	cantabile
ガウディ	Gaudi
キセノン	Xenon
キャビティー	cavity
キャンベル	Campbell
キヨズ	kiyo's
ギャレス	Gareth
クルル	Krull
クレア	clair
クローザー	closer
グライシンガー	Greisinger
グリズリー	grizzly
ケーシング	casing
ゲリ	Geli
ゲルト	Geld
コジモ	Cosimo
コロンバス	Columbus
コートジボアール	Cote d'Ivoire
ゴールドスミス	Goldsmith
サスペンダー	suspender
シノワ	chinois
シャドーイング	shadowing
シャリー	Schally
シャーマニズム	shamanism
シュトルム	Storm
シュビッタース	Schwitters
シュプレヒコール	Sprechchor
ジュート	jute
スカイラーク	skylark
スカラップ	scallop
スケープゴート	scapegoat
スタインウェイ	Steinway
スールー	Sulu
ゼム	gem
ゾディアック	zodiac
タニア	Tania
タンジール	Tangier
タントラ	tantra
ダイイング	dying
チノパン	chino pants
チューター	tutor
テベレ	Tevere
テンペラ	tempera
ディクショナリー	dictionary
デポルティーボ	deportivo
データグラム	datagram
トカラ	Tochara
トンガ	Tonga
ドーソン	Dawson
ナインティー	ninety
ナディア	Nadia
ナルコレプシー	narcolepsy
ネッシー	Nessie
ネームプレート	nameplate
ノーフォーク	Norfolk
ハウザー	Hauser
ハバネロ	habanero
バイアル	vial
バセドー	Basedow
バターン	Bataan
バックログ	backlog
バルビタール	barbital
バートラム	Bertram
バーナビー	Barnaby
バーミキュライト	vermiculite
バール	Waal
パミール	Pamir
パーフュージョン	perfusion
パーリ	pali
ビアン	bien
ファリード	Fareed
フィリング	filling
フィルチ	Filch
フェリーニ	Fellini
フォーカシング	focusing
フラノ	flano
フレージング	phrasing
ブハーリン	Bukharin
ブラッディー	bloody
ブルート	brute
プリモーリエ	Primorskaya
プルオーバー	pullover
プロコフィエフ	Prokofev
ベアトリクス	Beatrix
ホックニー	Hockney
ボウイ	Bowie
ボッテガ	bottega
ボルゾイ	borzoi
ポラリティー	polarity
ポリメラーゼ	polymerase
マイロ	milo
マクドネル	McDonnell
マスカレード	masquerade
マデイラ	Madeira
マージ	merge
マーベラス	marvelous
ミリオネア	millionaire
メガトン	megaton
メッシ	Messi
メリトクラシー	meritocracy
モトローラ	Motorola
モルドバ	Moldova
モントレー	Monterey
ヤンソン	Jansson
ユニセックス	unisex
ユリシーズ	Ulysses
ラザフォード	Rutherford
ラジオグラフィー	radiography
ラッチ	latch
ラムス	Ramus
ランタナ	Lantana
ランバン	Lanvin
リンド	Lindh
リンドン	Lyndon
ルピック	Lepic
ロタウイルス	rotavirus
アイルトン	Ayrton
アクロバチック	acrobatic
アグリーメント	agreement
アデン	Aden
アリックス	Alix
アルチュセール	Althusser
アルフォンス	Alfons
アレキサンドライト	alexandrite
アローン	alone
アンバンドル	Unbundling
アンモナイト	ammonite
アーリントン	Arlington
イマジン	imagine
イルクーツク	Irkutsk
イワノフ	Ivanov
ウインズ	WINS
ウインドサーフィン	windsurfing
ウッドストック	Woodstock
ウノ	uno
エコノミックス	economics
エリアス	Elias
エーリヒ	Erich
オシリス	Osiris
オレステス	Orestes
カティー	cutty
カトー	Cato
カフカス	Kavkaz
カロチノイド	carotenoid
カンフル	kamfer
ガゼット	gazette
ガルニ	garniture
キト	Quito
キャンプファイア	campfire
キュロット	culotte
キリエ	Kyrie
キロビット	kilobit
クリニカル	clinical
クロコ	crocodile
グリコール	Glykol
ケルベロス	Kerberos
ゲラー	Geller
コクーン	cocoon
コミュニズム	communism
コリンナ	Corinna
コルチコイド	corticoid
コルトー	Cortot
コンスタンティノポリス	Constantinopolis
コンフォート	comfort
ゴスペラー	gospeler
ゴルゴタ	Golgotha
サイディング	siding
サバルタン	subaltern
サピア	Sapir
サマーズ	Summers
サンタバーバラ	Santa Barbara
シェーダー	shader
シクロスポリン	cyclosporin
シンドバッド	Sindbad
ジェボンズ	Jevons
スウェー	sway
スキナー	Skinner
スクイズ	squeeze
スコーピオン	scorpion
ステイヤー	stayer
ストロンチウム	strontium
スピラプラズマ	Spiroplasma
スピロヘータ	Spirochate
スベン	Svend
スライ	sly
セゴビア	Segovia
セシリア	Cecilia
セミコロン	semicolon
セルラー	cellular
セレス	Ceres
ソナグラム	sonagram
ソフマップ	Sofmap
タイフーン	typhoon
タラソセラピー	thalassotherapy
タロ	taro
ダイキャスト	die-cast
ツェッペリン	Zeppelin
ツングース	Tungus
ツンベルク	Thunberg
ティボー	Thibaud
テレコミュニケーション	telecommunications
ディアスポラ	Diaspora
ディマジオ	DiMaggio
デオドラント	deodorant
デビ	Dewi
トライアンフ	Triumph
トラッシュ	trash
トリニティー	Trinity
ドゥルーズ	Deleuze
ドレッドノート	dreadnought
ドンキー	donkey
ヌル	null
ネクサス	nexus
ハイポニカ	hyponica
ハイム	Haim
ハヌマーン	Hanuman
ハンスト	hunger strike
バイカー	biker
バイポーラー	bipolar
バイヨンヌ	Bayonne
バケーション	vacation
バッラ	Valla
バハ	Baja
バラク	Barak
パグ	pug
パリジャン	parisien
パンタグラフ	pantagraph
パーサー	purser
ヒューマニスト	humanist
ヒーリー	Healey
ビアンコ	bianco
ビオチン	biotin
ビオフェルミン	Biofermin
ビルト	bild
ビーシャ	villa
ビードロ	vidro
ファブリス	Fabrice
ファルマン	Farman
フェニル	phenyl
フランクル	Frankl
フラー	Fuller
フローリン	Florin
ブレーンストーミング	brainstorming
ブロッキング	blocking
プレパラート	Praparat
プーシキン	Pushkin
ヘッケル	Haeckel
ベルグル	Worgl
ベーシスト	bassist
ポワレ	poeler
マイン	mine（代名詞）
マエストロ	maestro
マロ	Malot
マージャー	merger
メイベリン	Maybelline
メデジン	Medellin
メルシー	merci
ヤッケ	Jacke
ヤム	yam
ライヒス	Reichs
ラミネート	laminate
ラーゲリ	lager
ラーマン	Rahman
リエゾン	liaison
リダイヤル	redial
リチャーズ	Richards
リデュース	reduce
リドカイン	Lidocain
リドリー	Ridley
リフター	lifter
リボフラビン	riboflavin
リンカー	linker
レコンキスタ	Reconquista
レチノール	retinol
レムス	Remus
レーマン	Lehmann
ロジー	#ИМЯ?
ローアー	lower
ワラキア	Wallachia
アカプルコ	Acapulco
アシメトリー	asymmetry
アスピック	aspic
アトレティコ	atletico
アナトール	Anatole
アブノーマル	abnormal
アメリカーナ	Americana
アルハンブラ	Alhambra
アルブレヒト	Albrecht
アルミサッシ	aluminium sash
アンカラ	Ankara
アントレ	entree
アンビバレント	ambivalent
アーガー	Agha
アーティクル	article
アーニャ	Anja
イクスピアリ	IKSPIARI
イマーム	imam
インスタレーション	installation
インディアナポリス	Indianapolis
インバランス	imbalance
インボルブメント	involvement
ウパニシャッド	upanishad
エウトロピウス	Eutropius
エディット	edit
エレクトロ	electro
エロイーズ	Eloise
エンタメ	entertainment
エンバイロメンタル	environmental
エーブル	able
オクトパミン	octopamine
オスカル	Oscar
オラン	Orang
カバ	kava
カペラ	Capella
カメリア	Camellia
カラード	colored
カルダノ	Cardano
カーポート	carport
ガンプ	Gump
ガーネット	garnet
キュレネ	Cyrene
ギザ	Giza
ギニー	guinea
クラナド	Clannad
クリスティアン	Christian
クリフォード	Clyfford
クリンガー	Klinger
クリープ	creep
クルーソー	Crusoe
グリーンベルト	greenbelt
グルカゴン	glucagon
グレイッシュ	grayish
ケバブ	kabab
ココット	cocotte
コパ	copa
コミュニカティブ	communicative
コルセア	corsair
コーホート	cohort
コールスロー	coleslaw
サマセット	Somerset
サマルカンド	Samarkand
サルト	Sart
ザーメン	Samen
シャーリング	shirring
シュリンク	shrink
シラード	Szilard
ジェミー	Jemmie
ジーニアス	genius
スカビオサ	Scabiosa
スケートボード	skateboard
スコアボード	scoreboard
スザンネ	Susanne
ステンシル	stencil
スラッガー	slugger
セア	ther
ゾル	Sol
タイガ	taiga
タイド	tide
タキトゥス	Tacitus
タルクイニウス	Tarquinius
ダーリン	darling
ダーリング	Darling
チコリ	chicory
チョコボ	Chocobo
チラー	chiller
ディスティリング	distilling
ディラック	Dirac
デュッセルドルフ	Dusseldorf
トッテナム	Tottenham
トワレ	toilette
ドローバー	drawbar
ドワーフ	dwarf
ネブカドネザル	Nebuchadnezzar
ノバク	Novak
バイオリズム	biorhythm
バジリカ	basilica
バトゥル	baturu
バナジウム	vanadium
バランサー	balancer
バレンティノ	Valentino
バレンボイム	Barenboim
バンダ	vanda
パラツキー	Palacky
パラノイア	Paranoia
ヒューイ	Huey
ヒンデミット	Hindemith
ビスキュイ	biscuit
ビバップ	bebop
ビヨンセ	Beyonce
ビーイング	being
ピレウス	Piraeus
フィトンチッド	phytoncide
フィラー	filler
フェティシズム	fetishism
フェンウェイ	Fenway
フォカッチャ	focaccia
フランチシェク	Frantisek
フリーザー	freezer
フローリアン	Florian
ブリリアント	brilliant
ブルデュー	Bourdieu
プラトーン	platoon
プレシャス	precious
プロト	prototype
ヘンナ	henna
ベッラ	Bella
ベリン	Beline
ベリーズ	Belize
ペチコート	petticoat
ペッカ	Pekka
ペッパーズ	Pepper's
ペトロニウス	Petronius
ホジャ	Hodza
ホスファターゼ	phosphatase
ホーキング	Hawking
ボーディサッタ	bodhisattva
ポッカ	POKKA
ポッパー	Popper
ポリライン	polyline
マッカーシズム	McCarthyism
マニッシュ	mannish
マノン	Manon
マリラ	Marilla
マルケス	Marquez
マルメロ	marmelo
マンノース	mannose
マーケッター	marketer
マージナル	marginal
ムコ	muco
メチオニン	methionine
メフィスト	Mephisto
モナーク	Monarch
モネラ	Monera
モノコック	monocoque
ユマ	Uma
ヨニ	yoni
ライデン	Leiden
ラズリ	lazuli
ラマンチャ	La Mancha
ラロキシフェン	raloxifene
リガ	Riga
リジュベネーション	rejuvenation
リド	Lido
リート	Lied
レプラ	Lepra
レーカー	laker
ロチェスター	Rochester
ロックン	rock'n'
ロワゾ	L'oiseau
ロングヘア	longhair
アイガー	Eiger
アウトリーチ	outreach
アグリビジネス	agribusiness
アシル	acyl
アスピレーション	aspiration
アッツ	Attu
アナライザー	analyzer
アニパロ	animation parody
アマランス	amaranth
アルキビアデス	Alkibiades
アルテンベルク	Altenberg
アンラッキー	unlucky
インタープリター	interpreter
ウインドブレーカー	windbreaker
ウェスティン	Westin
ウェブスター	Webster
ウント	und
エグジット	exit
エスコフィエ	Escoffier
オマハ	Omaha
オリビア	Olivia
オーガンジー	organdy
オートポイエーシス	autopoiesis
オーブ	orb
オーブリー	Aubrey
カチューシャ	Katyusha
カテコールアミン	Catecholamine
カンプ	Kampf
ガトリング	Gatling
ガボン	Gabon
キャンギャル	campaign girl
キャンサー	cancer
キーナン	Keenan
キーレス	keyless
ギャバン	Gabin
ギラン	Guillain
クリンチ	clinch
クレセント	crescent
クロップド	cropped
クンデラ	Kundera
グラミー	Grammy
グランビル	Granville
グリーフ	grief
ケール	kale
ゲッター	getter
ゲッツー	get two
コスタ	Kosta
コズロフ	Kozlov
コッカー	cocker
コネクティング	connecting
コピーライト	copyright
コプラ	copra
コリドー	corridor
ゴグ	Gog
ゴッフマン	Goffman
ゴナドトロピン	gonadotropin
サウンダーズ	Sounders
サッカリン	saccharin
サンタフェ	Santa Fe
シェーマ	Schema
シャクルトン	Shackleton
シュムグラー	Schmuggler
シンシナティ	Cincinnati
ジェンマ	Gemma
ジハード	jihad
ジビエ	gibier
ジャズマン	jazzman
ジョリーン	Jolene
スコルツェニー	Skorzeny
スチュワード	steward
ストウ	Stowe
スプラッター	splatter
スム	sum
セイム	same
セナート	senate
セルバンテス	Cervantes
センチメンタリズム	sentimentalism
ソリティア	solitaire
ソーホー	SoHo
タブロー	tableau
ダウエス	Douwes
ダブ	daub
ダーラー	Dara
チラコイド	thylakoid
テレマーク	Telemark
ディプロマ	diploma
デコーダー	decoder
デュバル	Duval
デリカテッセン	Delikatessen
デント	dent
トゥルカナ	Turkana
トムキャット	tomcat
トランスポンダー	transponder
トル	torr
ドゥーガン	Dugan
ドゥーワップ	doo
ナボコフ	Nabokov
ヌンチオ	Nunzio
ノーチラス	Nautilus
ハマーン	Haman
ハルシオン	Halcion
ハーツフェルド	Hertzfeld
ハーバーマス	Habermas
バイナル	Vinyl
バガボンド	vagabond
バプテスマ	baptisma
バルバドス	Barbados
バレンシアガ	Balenciaga
バンタム	bantam
バーマン	Birman
パイパー	Piper
パッセージ	passage
パルサー	pulsar
パルテノン	Parthenon
ビジット	visit
ビネ	Binet
ビバーク	bivouac
ビレット	billet
ピチカート	pizzicato
ピンサロ	pink salon
ファイザー	Pfizer
ファタール	fatale
フィア	fear
フェッレリ	Ferreri
フォンタナ	Fontana
フォーカル	focal
フランダース	Flanders
ブギー	boogie
ブリン	Brin
ブレティン	bulletin
ブロス	bros
ブローカ	Broca
ブーブ	veuve
プライズ	prize
プリンシプル	principle
ヘイズ	haze
ヘッセン	Hessen
ベイン	Bain
ベツレヘム	Bethlehem
ベナレス	Benares
ベート	bete
ペルーズ	Perouse
ペンタゾシン	pentazocine
ページェント	pageant
ボツワナ	Botswana
ポンポン	pompon
ポーション	portion
マゾヒズム	Masochism
マルシェ	marche
マルティーヌ	Martine
マレ	Male
マンダレー	Mandalay
マーリー	Marley
ミオシン	myosin
ミストラル	mistral
ムガル	Mughal
ムスク	musk
メッケル	Meckel
メロス	melos
モウリーニョ	Mourinho
モジラ	Mozilla
モビリティー	mobility
モンツァ	Monza
モーダル	modal
ラップトップ	laptop
ラビング	loving
ランベール	Lambert
リセッション	recession
リヒテンシュタイン	Liechtenstein
リボソーム	ribosome
ルミナス	luminous
レストン	Reston
レーブ	reve
ロジカル	logical
ロードス	Rhodos
ワルファリン	warfarin
ワンダーランド	wonderland
アザレア	azalea
アデノウイルス	adenovirus
アパラチア	Appalachia
アムネスティー	amnesty
アリュート	Aleut
アルチュール	Arthur
アルヘンタ	Argenta
アンパイア	umpire
イノセント	innocent
イミュニティ	Immunity
イルミナティ	illuminati
インクルーシブ	inclusive
インターセプト	intercept
インポテンツ	Impotenz
ウェルニッケ	Wernicke
ウォルシュ	Walsh
エターナル	eternal
エナン	Henin
エネミー	enemy
エピネフリン	epinephrine
エフィンガム	Effingham
エミッター	emitter
エリントン	Ellington
オイゲン	Eugen
オーファン	orphan
カダフィー	Qadhafi
カリーノ	carino
カンダウレス	Kandaules
ガガーリン	Gagarin
キャピトル	Capitol
キルシュ	kirsch
ギャラン	galant
クマリン	coumarin
クラランス	Clarins
クレージュ	Courreges
クロシャール	clochard
グリコシド	glycoside
グレゴリオス	Gregorios
グレーハウンド	grayhound
グロッキー	groggy
ケーパビリティー	capability
ゲートル	guetre
コンフェデ	confederation
サキソホン	saxophone
ザンジバル	Zanzibar
シェービング	shaving
シケイン	chicane
シスト	cyst
シダックス	SHiDAX
シベリウス	Sibelius
シャンク	shank
シャンティー	Chantilly
シャール	Char
シンセ	synthesizer
シンパシー	sympathy
シーガー	Seeger
シーメンス	Siemens
ジゴキシン	digoxin
ジャーヌ	Jane
スカリー	Sculley
スキミング	skimming
スタティック	static
スプートニク	sputnik
スペリング	spelling
スラウェシ	Sulawesi
スローイング	throwing
セニョリータ	senorita
センチネル	sentinel
セービング	saving
セーリング	sailing
ゼファー	zephyr
ソフィスト	sophist
ソーヤー	Sawyer
タオス	Taos
タマリン	tamarin
タリオ	talio
チェンバレン	Chamberlain
チョボ	jo bo
チルド	chilled
ツアコン	tour conductor
ツアラー	tourer
ツェルト	Zelt
ツタンカーメン	Tutankhamen
テルペン	terpene
テーパー	taper
ディアギレフ	Diagilev
ディセンバー	december
デコラ	decola
デコード	decode
デビッドソン	Davidson
デフォ	default
デミウルゴス	Demiourgos
トカチェンコ	Tkachenko
トローチ	troche
ドラング	drang
ドレッシー	dressy
ナク	Nak
ハイデルベルク	Heidelberg
ハシシュ	hashish
バウ	bow
バトシェバ	Bathsheba
バンナ	Banner
バーガンディー	burgundy
バーニング	burning
バーニーズ	Barneys
パッセ	passe
パンタ	pantograph
パーシュース	Perseus
ピグミー	pygmy
ピジン	pidgin
ピッコロ	piccolo
ピナフォア	pinafore
ピューリツァー	Pulitzer
ピンナップ	pinup
ピーターソン	Peterson
フェライト	ferrite
フォッサ	Fossa
フラッシュバック	flashback
ブギス	Bugis
ブライン	brine
ブルトン	Breton
ブレヒト	Brecht
ブロークン	broken
ヘイスティングズ	Hastings
ベネディクトゥス	Benedictus
ベルヌ	Verne
ベルヌーイ	Bernoulli
ホイッパー	whipper
ホイヘンス	Huygens
ホワッツ	what's
ボゴタ	Bogota
ボルカノ	Borkano
ボンゴ	bongo
ポジトロン	positron
ポトス	pothos
マスカルポーネ	mascarpone
マニュファクチャー	manufacture
マネ	Manet
ミスリード	mislead
ミダゾラム	midazolam
メイヨー	Mayo
ユカタン	Yucatan
ヨハンナ	Johanna
ラザール	Lazare
ランクル	Landcruiser
リサイクリング	recycling
リビドー	libido
リボゾーム	ribosome
ルドン	Redon
レイモン	Raymon
レニン	renin
ワーテルロー	Waterloo
アウル	owl
アダプティブ	adaptive
アドウェア	adware
アヌラーダプラ	Anuradhapura
アビスパ	avispa
アフラトキシン	aflatoxin
アルゴス	Argos
アルフ	Alf
アンシャン	ancien
アンテプリマ	anteprima
イディオム	idiom
イブラヒム	Ibrahim
インクルード	include
ウエペケレ	uepeker
ウォルフ	Wolf
ウランバートル	Ulanbator
エゴイスティック	egoistic
エティエンヌ	Estienne
エルズミア	Ellesmere
エンザイム	enzyme
エンヤ	Enya
オナシス	Onassis
オプティカル	optical
オペレーショナル	operational
オルト	alternative
オーケストレーション	orchestration
オーネット	Ornette
カトラリー	cutlery
カブリ	cabri
カルガリー	Calgary
カンツォーネ	canzone
カーミル	Kamil
ガンダルフ	Gandalf
キャセロール	casserole
キャッサバ	cassava
クナ	Kna
クライバー	Kleiber
クリムト	Klimt
クレマン	Clement
クロッシング	crossing
グリシン	glycine
グループウェア	groupware
グレートジール	Greetsiel
グロッグ	grog
ケアマネ	care manager
コッパ	coppa
コヒーレント	coherent
コングレス	congress
コンシャス	conscious
コンデ	Conde
コントレックス	Contrex
コンピレーション	compilation
コーキング	caulking
ゴレン	goreng
ゴーディマー	Gordimer
サイリスター	thyristor
サウスカロライナ	South Carolina
サブトラクション	subtraction
サロ	Salo
サンドバッグ	sandbag
サーパス	surpass
ザッツ	Satz
シネコン	cinema complex
シベリアン	Siberian
シャノン	Shannon
シャルパンティエ	Charpentier
シュタウフェンベルク	Stauffenberg
シュトゥルム	Sturm
ショッカー	shocker
シーム	seam
ジオキサン	dioxane
ジュネ	Genet
ジューコフ	Zhukov
ジーター	Jeter
スイッチバック	switchback
スカルラッティ	Scarlatti
ストレプトマイシン	streptomycin
ストーリーテリング	storytelling
スパニエル	spaniel
スピカ	spica
スレード	Slade
セレクチン	selectin
ソネット	sonnet
ソロン	Solon
ゾーニング	zoning
タウリン	taurine
タスマニア	Tasmania
タッセル	tassel
ターゲッティング	targeting
ダイク	Dyck
ダイナスティ	dynasty
ダイモン	daimon
ダルエスサラーム	Dar es Salaam
ダーウィニズム	Darwinism
チェアマン	chairman
チェルヌイシェフスキー	Chernyshevskii
チム	chim
チモシー	timothy
ティンパニ	timpani
テイン	theine
テロル	Terror
ディッキー	Dicky
デフレーション	deflation
デュラハン	Dullahan
デュレーション	duration
デントン	Denton
トア	tor
トゥーム	tomb
トラコーマ	trachoma
トランスフォーム	transform
トレパン	training pants
ドゥオーモ	Duomo
ドーラン	Dohran
ナジャフ	Najaf
ナホトカ	Nakhodka
ナルシス	Narcisse
ニトラゼパム	Nitrazepam
ネイピア	Napier
ネモ	Nemo
ノベルティー	novelty
ハイラム	Hiram
ハッシュ	hash
ハバード	Hubbard
バラハ	Baraja
バンコマイシン	Vancomycin
バンドネオン	bandoneon
バーカー	barker
バーサ	Vassa
パイント	pint
パウ	Pau
パガニーニ	Paganini
パライソ	paraiso
パーセク	parsec
ヒッコリー	hickory
ビショフ	Bischof
ビスカヤ	Vizcaya
ビッグローブ	BIGLOBE
ビドック	Vidocq
ビーバー	beaver
ピラニア	piranha
ファブ	fab
フォニックス	phonics
フライス	fraise
フリーウェー	freeway
フレキシビリティー	flexibility
フレーザー	Frazer
フロイライン	Fraulein
フローズン	frozen
ブラッドレー	Bradley
ブラフ	bluff
ブランデンブルク	Brandenburg
ブリム	brim
ブリューゲル	Brueghel
ブリーズ	breeze
ブルネレスキ	Brunelleschi
ブレスラウ	Breslau
プネー	Pune
プラスター	plaster
プリズン	prison
プルタルコス	Plutarchos
ヘディン	Hedin
ヘルダーリン	Holderlin
ベッリンチョーニ	Bellincioni
ペティー	petty
ペプシン	pepsin
ペプチドグリカン	peptidoglycan
ペンドリーノ	Pendolino
ホセア	Hosea
ホムペ	homepage
ホワイ	why
ボアズ	Boas
ボスニアヘルツェゴビナ	Bosna i Hercegovina
ボヤージュ	voyage
ボルツマン	Boltzmann
ボンジュール	bonjour
ポインセチア	poinsettia
ポワチエ	Poitiers
マイクロメーター	micrometer
マグノリア	magnolia
マネタリズム	monetarism
マラルメ	Mallarme
マルキスト	Marxist
ミッレ	mille
ミンスク	Minsk
モガディシオ	Mogadiscio
モラリスト	moralist
ユリ	Uri
ラビリンス	labyrinth
ラフカディオ	Lafcadio
ラホール	Lahore
ラングレー	Langley
リバーサル	reversal
リビルド	rebuild
リンドバーグ	Lindbergh
ルクレール	Leclerc
ルツェルン	Luzern
ルテイン	Lutein
ルーバン	Leuven
レリア	laelia
ロルフィング	Rolfing
アクチン	actin
アクロス	across
アサド	Asad
アスワン	Aswan
アズーリ	azzurri
アニサキス	Anisakis
アモール	amor
アラニン	alanine
アルカイック	archaique
アルケン	alkene
アルデンテ	al dente
アルム	Alm
アンダーシャツ	undershirt
アンチモン	Antimon
アーニー	Ernie
イグマン	Igman
イサーン	Isan
イシュタル	Ishta
イワーノブナ	Ivanovna
インターラクション	interaction
インターレグ	interreg
インパラ	impala
インフェルノ	inferno
イーガン	Egan
ウィロビー	Willoughby
ウインチ	winch
ウォルトン	Walton
ウラマー	ulama
ウリエル	Uriel
ウルスラ	Ursula
エウリピデス	Euripides
エクソシスト	exorcist
エトナ	Etna
エピクロス	Epikouros
エマージェンシー	emergency
エリシャ	Elisha
エンゲージ	engage
オクタン	octane
オコンネル	O'Connell
オディール	Odile
オブスキュラ	obscura
オーディン	Oden
カズン	cousin
カプリス	caprice
カレッタ	caretta
ガイウス	Gaius
ガモフ	Gamow
ガラクトース	galactose
ガリシア	Galicia
ガート	ghat
キャリントン	Carrington
キューブリック	Kubrick
ギルフォード	Guilford
クスコ	Cuzco
クラッパートン	Clapperton
クリステンセン	Christensen
クレゾール	Kresol
クレッチマー	Kretschmer
クレバー	clever
クロッキー	croquis
クーリエ	courier
グラジオラス	gladiolus
グリコサミノグリカン	glycosaminoglycan
グリンゴッツ	Gringotts
グルテン	gluten
グルーミング	grooming
グレチコ	Grechko
ケラチン	keratin
ケンネル	kennel
コビシント	Covisint
コラール	Choral
コンサートマスター	concertmaster
コンティニュー	continue
コンバーティブル	convertible
コンポーザー	composer
コーンウォール	Cornwall
サイドライン	sideline
サバト	sabado
サルセン	sarsen
サンテグジュペリ	Saint Exupery
サーディン	sardine
シウバ	Silva
シスレー	Sisley
シッピング	shipping
シトリン	citrine
シャモット	chamotte
シルバーナ	Silvana
シーイング	seeing
シーゲル	Siegel
シーヌ	Chine
シーモア	Seymour
シーラー	sealer
ジェンソン	Jenson
ジャカード	jacquard
ジョホール	Johore
ジョージタウン	Georgetown
ジンク	zinc
スケボー	Skateboard
スターダム	stardom
ストロガノフ	stroganoff
スモック	smock
スリッペリー	Slippery
スリーマイル	Three Mile
ズロース	drawers
セイウチ	sivuch
セマンティック	semantic
セリヌンティウス	Celenuntius
セロニアス	Thelonious
セーガン	Sagan
タクラマカン	Takla Makan
ダウト	doubt
ダガー	dagger
ダップル	dapple
チャルメラ	charamela
テトラクロロエチレン	tetrachloroethylene
テレターミナル	teleterminal
テンダー	tender
テークオフ	take-off
ディケード	decade
デイノニクス	Deinonychus
デックス	Decks
デナリウス	denarius
デング	dengue
トリプレット	triplet
トルバ	Tolba
トレッドミル	treadmill
トロリー	trolley
トングウェ	Tongwe
ドモホルンリンクル	domohornwrinkle
ドリフターズ	Drifters
ナセル	Nasir
ニスロン	Niceron
ニュートラ	new traditional
ヌエバ	Nueva
ネゴシエーション	negotiation
ネストリウス	Nestorius
ノギス	Nonius
ハイパーテキスト	hypertext
ハイポジウム	Hypogeum
ハモンド	Hammond
バラナシ	Varanasi
バンケット	banquet
バージ	barge
バーバー	barber
パウダリー	powdery
パウチ	pouch
パケダイ	packet
パドバ	Padova
パルトロー	Paltrow
パルム	palme
パロール	parole
パーチ	perca
ヒューロン	huron
ビブリオ	vibrio
ビーガン	vegan
ピッギー	piggy
ファド	fado
フィジック	physics
フィズ	fizz
フィニッシング	finishing
フィロソフィー	philosophy
フェーム	fame
フレーベル	Flavell
ブラッドフォード	Bradford
ブルンジ	Burundi
ブレイディー	Brady
ブロット	blot
プラバー	plover
プログレ	progressive
プロジェクション	projection
プロテオグリカン	proteoglycan
プロファイリング	profiling
ヘルバルト	Herbart
ヘンドリクス	Hendrix
ベルトルッチ	Bertolucci
ペーズリー	paisley
ホモフォビア	Homophobia
ホルスタイン	Holstein
ホルツ	Holtz
ホログラフィー	holography
ホーミング	homing
ボナ	Bonner
ポアレ	Poir
ポストモダニズム	postmodernism
ポピュレーション	population
ポルトフィーノ	Portofino
ポンテ	ponte
マジェスタ	majesta
マリガン	Mulligan
マレーズ	Marese
ミントン	Minton
ムーディー	moody
メロディアス	melodious
モイセーエフ	Moiseev
モダリティ	modality
モンバサ	Mombasa
ユンカース	Junkers
ライモンダ	Raymonda
リビングストン	Livingstone
リファイン	refine
リンネ	Linne
ルアンパバーン	Luang Phabang
ルノートル	Lenotre
ルフェーブル	Lefebvre
ルフトハンザ	Lufthansa
レディネス	readiness
レノー	Raynaud
ロジェストベンスキー	Rozhdestvenskii
ローフ	loaf
ワイツゼッカー	Weizsacker
ワイナー	Weiner
アクオス	Aquos
アクサ	AXA
アックス	ax
アデノイド	adenoid
アドラー	Adler
アビス	abyss
アレッツォ	Arezzo
アロガンス	Arrogance
アンバー	amber
アンビリーバブル	unbelievable
アーン	Arn
イズベスチヤ	Izvestia
イディッシュ	Yiddish
イバン	Iban
イプサム	Ipsum
インスティチューション	institution
インステップ	instep
ウディネーゼ	udinese
エアサス	air suspension
エクスキューズ	excuse
エクリチュール	ecriture
エックハルト	Eckhart
エビアン	Evian
エビングハウス	Ebbinghaus
エルス	else
エープ	ape
オカピ	okapi
オレイン	Olein
オーチャード	orchard
カイアファ	Kayafa
カモン	come on
カリニ	carini
ガスパルト	Gaspart
ガリアーノ	Galliano
ガロワ	Gallois
キノホルム	Chinoform
キノロン	quinolone
キャスケット	casquette
キャセイ	Cathay
キャリコット	Callicott
キュビエ	Cuvier
キュビット	cubit
キュベレイ	qubeley
ギャランティー	guarantee
ギヨー	guyot
クチュリエ	couturier
クループ	croup
クレパス	Craypas
クワッド	quad
グリーバス	Grievous
グルコン	gluconic
ケイラン	Kaylan
ケストナー	Kastner
ケーニヒスベルク	Konigsberg
ゲネプロ	general probe
コヒーラー	coherer
コミュニケーター	communicater
コルネ	cornet
コルポ	colpo
コンタミ	contamination
コンテンポラリー	contemporary
コンフェデレーション	confederation
コーデックス	codex
ゴルカル	Golkar
サイバースペース	cyberspace
サイマル	simul
サウスポー	southpaw
サラディン	Saladin
サーフェス	surface
シェンケル	Schenkel
シエナ	sienna
シエラレオネ	Sierra Leone
シシー	sissy
ショートニング	shortening
ジェルトリュード	Gertrude
ジャグラー	juggler
ジョルダーノ	Giordano
ジーズ	these
スカトロ	scatology
スケジューリング	scheduling
スタッカート	staccato
スチュクス	Styx
ステーター	stator
ストランド	strand
スビーテン	Swieten
スローダウン	slowdown
セノイ	Senoi
セミファイナル	semifinal
セラミド	ceramide
センチュリオン	centurion
ソリドゥス	Solidus
ソリュード	Solud
ソルフェージュ	solfege
ターボチャージャー	turbocharger
ダライ	draaibank
ダンヒル	Dunhill
チラン	Tiran
チンチラ	chinchilla
ティトゥス	Titus
テレタイプ	teletype
ディメンション	dimension
デコラティブ	decorative
デサイ	Desailly
トスカ	Tosca
トトカルチョ	totocalcio
トランシルバニア	Transylvania
トリソミー	trisomy
トロリーバス	trolleybus
トーリー	Tory
ドレッド	dread
ナイトキャップ	nightcap
ナパーム	Napalm
ナビゲート	navigate
ナローバンド	narrowband
ナワ	Nahua
ニガー	nigger
ネメシス	Nemesis
ネロリ	neroli
ノルマル	Normal
ノーブラ	no brassiere
ハムステッド	Hampstead
ハーデス	Hades
バサエフ	Basavev
バジリコ	basilico
バニヤン	banyan
バラクーダ	barracuda
バレッタ	barrette
バーベナ	Verbena
パチーノ	Pacino
パリジェンヌ	parisienne
パンサ	Panza
パーチェ	pace
パーミッション	permission
ヒューマノイド	humanoid
ビハール	Bihar
ビートン	Beeton
フィロゾーフ	philosophe
フィールディング	fielding
フェノバルビタール	phenobarbital
フェビアン	Fabian
フォッカー	Fokker
フォートワース	Fort Worth
フォーリー	Foley
フリッター	fritter
フリーゲンデ	Fliegende
フルード	fluid
フレッシュマン	freshman
フーリガン	hooligan
ブイヤベース	bouillabaisse
ブライアント	Bryant
ブルクドルフ	Burgdorf
ブースビー	Boothby
プリメーラ	primera
プレスト	pressed
プログレッシブ	progressive
プロフェッション	profession
ベスビオ	Vesuvio
ベネルクス	Benelux
ベブレン	Veblen
ベルガモット	bergamot
ベンド	bend
ペップ	Pep
ペロン	Peron
ペンタ	pentaprism
ホイットフィールド	Whitfield
ホッパー	hopper
ホーマック	Homac
ボッツ	Botts
ボロー	Burroughs
ボーマルシェ	Beaumarchais
ボールド	bald
ポシブル	possible
ポランニー	Polanyi
ポリカーボネート	polycarbonate
ポーリーヌ	Pauline
マイネ	meine
マカッサル	Macassar
マリス	Maris
マレーネ	Marlene
ミトン	mitten
ミルウォーキー	Milwaukee
メスナー	Messner
メソ	meso
メチシリン	methicillin
メドック	Medoc
メルローズ	Melrose
メービー	maybe
モケット	moquette
モタ	mota
ヤップ	Yap
ユングフラウ	Jungfrau
ラウス	Rous
ラクト	lactose
ラニエリ	Ranieri
リゴレット	Rigoletto
リサイズ	resize
リッチネス	richness
リッパー	ripper
リトルトン	Littleton
リノベーション	renovation
リンクス	lynx
ルブタン	Louboutin
レシチン	lecithin
レーキ	rake
ロマーノ	Romano
ローエングリン	Lohengrin
ロードワーク	roadwork
ローミング	roaming
ワイプ	wipe
ワルキューレ	Walkure
ワルド	Waldo
アイディアル	ideal
アジリティー	agility
アストラル	astral
アセンブリー	assembly
アッカド	Akkad
アッチソン	Atchison
アノラック	anorak
アマルガム	amalgam
アルバイター	Arbeiter
アルペッジョ	arpeggio
アングラー	angler
アンニュイ	ennui
アートマン	atman
インディアカ	Indiaca
インディペンデンス	independence
イントロダクション	introduction
インプレス	impress
イーガー	eager
イーデン	Eden
ウイリー	wheelie
ウォルフォウィッツ	Wolfowitz
ウォント	want
ウォータールー	Waterloo
ウムラウト	Umlaut
ウリット	ulit
エキゾチシズム	exoticism
エシュロン	echelon
エスキス	esquisse
エディトリアル	editorial
エドマンド	Edmund
エレジー	elegy
エンテロウイルス	enterovirus
オケアノス	Okeanos
オットリーン	Ottoline
オランザピン	olanzapine
オービー	Obie
カタストロフィー	catastrophe
カタラーゼ	Katalase
カパ	Kapha
カムラン	Cam Ranh
カルバドス	calvados
カンテ	Kante
カンポ	Campo
カーポ	capo
ガストリン	gastrin
ガトウィック	Gatwick
ガレリア	galleria
ガンダーラ	Gandhara
ガーナー	Garner
キドニー	kidney
クオート	quart
クリプトン	krypton